-------------------
```
प्रखण्ड- --- ना. [सं.] --- १. कुनै कुराको सानो भाग; उपखण्डभन्दा पनि सानो खण्ड। २. कोठाभित्रको कोठो; भित्री कोठो।
प्रखर- --- वि. [सं.] --- १. ज्यादै तेजिलो; कडा; उग्र; प्रचण्ड। २. अतिशय कडा स्वभावको; ज्यादै खरो। ३. तीव्र गति वा वेग हुने; द्रुतगतिको (बुद्धि, प्रवाह आदि)।
प्रखरता- --- ना. --- प्रखर हुनाको भाव गुण वा अवस्था; अतिशय तीव्रता; प्रचण्डता; उग्रता।
प्रख्यात- --- वि. [सं.] --- नाउँ चलेको; कीर्ति फैलिएको; प्रसिद्ध।
प्रख्याति- --- ना. --- प्रसिद्धि।
प्रख्यापन- --- ना. [सं.] --- १. ख्याति बढाउने कुनै उपाय (लेख, गतिविधि, निर्माण, कलाकृति आदि); ख्यातिको विज्ञापन। २. जनाउ दिने कार्य।
प्रख्यापित- --- वि. [सं.] --- १. सर्वसाधारण जनतालाई जनाउ दिइएको वा बोध गराइएको; सर्वसाधारणले थाहा पाउने गरी घोषणा गरिएको वा जारी गरिएको (सरकारी इस्तिहार, अध्यादेश, आज्ञप्ति, विज्ञप्ति, राज्यादेश आदि)। २. प्रसिद्ध तुल्याइएको; प्रख्यात।
प्रगत- --- वि. [सं.] --- १. अघिल्तिर गएको। २. अघिल्लो वर्णको प्रभावमा परेर पछिल्लो वर्ण पनि अघिल्लो वर्ण जस्तै बन्ने (एक प्रकारको समीभवन, जस्तै- सं. पक्व > प्रा. पक्क आदि)।
प्रगति- --- ना. [सं.] --- राम्रोसित अगाडि बढ्ने क्रिया; माथि उक्लने क्रिया; राम्रोसित अगाडि बढ्‌नाको भाव, क्रिया वा प्रक्रिया; उन्नति; विकास; उत्थान।
प्रगतिमूलक- --- वि. --- १. प्रगतिलाई देखाउने (विवरण आदि)। २. प्रगतिका उद्देश्यले गरिने।
प्रगतिरोधक- --- वि. --- कुनै कामकुरामा भइरहेको प्रगतिमा बाधा वा अवरोध पैदा गर्ने; प्रतिक्रियावादी; प्रगतिविरोधी।
प्रगतिवाद- --- ना. --- साहित्यलाई समाजको उपज मान्दै सामाजिक यथार्थको अभिव्यक्तिमा जोड दिने, वैयक्तिक आनन्दलाई भन्दा समाजको भौतिक विकासलाई बढी महत्त्व दिने, मार्क्सवादबाट प्रभावित साहित्य-सिद्धान्त; यथार्थवादको प्रकृतवादी शाखादेखि भिन्न अर्को समानान्तर शाखा।
प्रगतिवादी- --- वि. --- प्रगतिवादमा विश्वास गर्ने; प्रगतिवादको अनुयायी।
प्रगतिशील --- वि. --- १. समाजको उत्तरोत्तर विकासमा विश्वास गर्ने। २. मार्क्सवादी सिद्धान्तअनुसार सामाजिक प्रगतिमा विश्वास गर्ने।
प्रगतिशीलता --- ना. --- प्रगतिशील हुने गुण, स्वभाव वा प्रक्रिया।
प्रगन्ना- --- ना. [फा. पर्गन] --- १. जिल्लाअन्तर्गत धेरै मौजा मिलाई बनाइएको एउटा भूभाग; धेरै गाउँ भएको भूभाग। २. नयाँ भूमिव्यवस्था लागु हुनुभन्दा पूर्व तराईमा जिल्लाभन्दा सानो र मौजाभन्दा ठुलो प्रशासनिक भूखण्ड; पहाडका थुम, गर्खा आदिसँग तुलनीय तराइली भूखण्ड।
प्रगल्भ- --- वि. [सं.] --- १. मौकाअनुसार काम-कुरा गर्न सक्ने बुद्धि भएको; जानेको-सुनेको; प्रत्युत्पन्नमति। २. मौकाअनुसार काम- कुरा गर्न पछि नहट्ने; कसैको डरधम्कीमा नपरी मनमा लागेका कुरा निर्धक्क भएर भन्न सक्ने; निडर भएर बोल्न सक्ने; बोलक्कड। ना. ३. गुड्डीहँकाइ; फुर्तीफार्ती; धमास। ४. अवसरवाद। ५. चङ्ख्याइँ।
प्रगल्भता- --- ना. --- प्रगल्भ।
प्रगल्भा --- ना. --- १. प्रगल्भ स्वभावकी नारी। २. नायकसँग नधकाउने प्रौढा नायिका; साहित्यका अनुसार नायिकाको एक भेद।
प्रगल्भित- --- वि. --- १. मौकाअनुसार गरिएको। २. धक नराखी बोलिएको। ३. अवसरवादी वा बोलक्कडमा परिणत। ४. चड्खे।
प्रगाढ- --- वि. [सं.] --- १. ज्यादै गहिरो; गहन; गम्भीर। २. अतिशय धेरै; निकै। ३. कसिएको; मसक्क पारिएको (आलिङ्गन)।
प्रगीत- --- ना. [सं.] --- मूलतः भावनानुकूल लयमा निजी अनुभूतिको अभिव्यक्ति रहने तथा गीतकारको विशिष्ट व्यक्तित्व प्रकट हुने गीत। २. गीत; गाना।
प्रगीतकाव्य- --- ना. --- कविको आत्मानुभूतिले पूर्ण, सङ्गीतात्मक वा गेयात्मक तत्त्व ले युक्त, उक्त प्रकारको काव्य; गेय काव्य।
प्रगुण- --- ना. [सं.] --- १. राम्रो गुण भएको; गुणवान्; गुणी। २. राम्रो र लाभदायक। ३. होसियार; चतुर। ना. ४. परिश्रम तथा प्रयत्नपूर्वक आर्जिन कुनै गुण वा विशिष्टता; निपुणता; दक्षता।
प्रगुण अर्गल --- ना. --- नियमानुसार कुनै सरकारी वा अर्धसरकारी सेवामा रहेका कर्मचारीहरूको वेतनवृद्धि आदि पराकाष्ठामा पुग्ने प्रणाली; दक्षता-अर्गल (एफिसियन्सी-बार)।
प्रगुणता- --- ना. --- राम्रो गुण हुने स्थिति, अवस्था वा क्षमता।
प्रघटक- --- ना. [सं.] --- १. निया वा सिद्धान्त। २.आदेश। ३. घटक।
प्रघट्टक- --- ना. [सं.] --- १. अनुच्छेद। २. प्रघटक।
प्रघर्षण- --- ना. [सं.] --- १. विशेष प्रकारको घर्षण। २. रगेडाइ, घोटाइ। ३. बँगारुको बोट।
प्रघर्षित- --- वि. --- घर्षण भएको; घोटिएको।
प्रचण्ड- --- वि. [सं.] --- १. ज्यादै चर्को स्वभावको; ज्यादै मापाको; ज्यादै खरो। २. कसैदेखि नदब्ने; नडराउने; साहसी; आँटिलो। ३. सहन मुस्किल पर्ने; असत्य; दुःसह।
प्रचलन- --- ना. [सं.] --- १. चलाइ; गति; हिँडाइ। २. चालचलन; चलन।
प्रचलित- --- वि. [सं.] --- प्रचलनमा रहेको वा आएको; चलनचल्तीको (नाप, तौल, नियम, मान्यता इ.)।
प्रचलित नेपाल कानुन- --- ना. --- नेपालमा हाल चलनचल्तीमा रहेको ऐनकानुन।
प्रचार- --- ना. [सं.] --- १. कुनै वस्तु वा कुरालाई कुनै उपायले निरन्तर वा व्यापक रूपमा फैलाउने क्रिया; कुनै कुरालाई बराबर उपयोग वा व्यवहारमा ल्याउने काम। २. कुनै विचार, सिद्धान्त वा उल्लेखनीय समाचार आदिबारे विज्ञापन, पोस्टर, लेख आदिका माध्यमले सर्वसाधारणलाई जानकारी दिन गरिने कार्य। ३. उपर्युक्त आधारमा लोकप्रिय बनाउनका निम्ति प्रचारित गरिने कुनै पनि कुरो । ४. प्रसिद्धि।
प्रचारक- --- वि. --- प्रचार गर्ने; फैलाउने।
प्रचारण- --- ना. --- कुनै वस्तु वा कुराको प्रचार गर्ने क्रिया वा भाव।
प्रचारणीय- --- वि. --- प्रचार गर्नुपर्ने; प्रचार गर्न लायक।
प्रचारिणी- --- वि. --- कुनै कुरा वा भाषा, संस्कृति आदिको प्रचार गर्ने (सभा आदि)।
प्रचारित- --- वि. --- प्रचार गरिएको; कुनै उपायले सर्वसाधारणको
प्रचारी- --- वि. --- प्रचारक।
प्रचालक- --- वि. [सं.] --- १. प्रचलनमा ल्याउने (व्यक्ति)। २. चलाउने; चालित गर्ने। ना. ३. चालक (ड्राइभर, बैलवान, सारथि आदि)।
प्रचुर- --- वि. [सं.] --- प्रशस्त; पर्याप्त; पौल; मनग्य; थुप्रो; औलदौल।
प्रचुरता- --- ना. --- प्रचुर हुनाको भाव; पर्याप्तता; पौल।
प्रचेष्टा- --- ना. [सं.] --- कुनै कामकुराका लागि गरिने विशेष किसिमको चेष्टा; विशेष प्रयास।
प्रच्छन्न- --- वि. [सं.] --- १. बाहिर प्रकाशमा नआएको; छोपिएको (जस्तो- प्रच्छन्न शरीर)। २. नदेखिने; लुकेको (जस्तो- प्रच्छन्न धन)।
प्रच्छादक- --- वि. [सं.] --- १. ढाक्ने वा छोप्ने। २. छिपाउने; लुकाउने।
प्रच्छादन- --- ना. [सं.] --- १. कुनै वस्तु वा कुरालाई ढाक्ने काम; छोप्ने कार्य। २. प्रच्छद ।
प्रच्छादित- --- वि. [सं.] --- छोपिएको; ढाकिएको।
प्रजन- --- ना. [सं.] --- १. प्रजनन । वि. २. जन्म दिने; जन्मदाता।
प्रजनन- --- ना. [सं.] --- १. सन्तान पैदा गर्ने क्रिया; बच्चा जन्माउने काम। २. गर्भबाट उत्पन्न हुने क्रिया; जन्म; उत्पत्ति।
प्रजनन क्रिया- ---  --- गर्भाधानका निम्ति पोथी पशुसित भाले लाउने काम।
प्रजननशील- --- ना. --- प्रजनन वा पैदा हुने; उत्पादनशील।
प्रजनयिता- --- ना. [सं.] --- जन्म दिने व्यक्ति; पिता।
प्रजनिका- --- ना. [सं.] --- जन्म दिने नारी; आमा।
प्रजल्प- --- ना. [सं.] --- काम नलाग्ने कुरा; अनावश्यक गफ।
प्रजा- --- ना. [सं.] --- १. राजाद्वारा शासित देशका जनता; राजतन्त्रात्मक देशका जनता; रैती। २. कुनै राज्य वा राष्ट्रमा रहेको जनसमूह। ३. सन्तान; सन्तति। ४. चेपाङ ।
प्रजातन्तु- --- ना. --- १. सन्तानको अविच्छिन्न परम्परा; सन्तानको लहरो। २. अविच्छिन्न वंशपरम्परा।
प्रजातन्त्र- --- ना. [सं.] --- १. प्रजा वा जनताद्वारा निर्वाचित, जनप्रतिनिधिद्वारा चलाइने शासनव्यवस्था; जनप्रतिनिधिका हातमा शासनसत्ता भएको राज्यव्यवस्था। २. जनताद्वारा जनताका लागि जनताकै रायसल्लाहबाट चलाइने शासन।
प्रजातन्त्र दिवस- --- ना. --- नेपालमा २००७ सालमा प्रजातन्त्र आएको उपलक्ष्यमा बर्सेनि फागुन ७ गते मनाइने राष्ट्रिय उत्सव।
प्रजातन्त्रवाद- --- ना. --- प्रजातन्त्रलाई महत्त्व दिने सिद्धान्त; प्रजातन्त्रका सिद्धान्त ।
प्रजातन्त्रवादी- --- वि. --- प्रजातन्त्रवादमा विश्वास राख्ने; प्रजातन्त्रको अनुयायी।
प्रजातन्त्र श्रीपद- --- ना. --- राजा त्रिभुवनका नाममा स्थापित छ श्रेणीमा विभक्त एक तक्मा।
प्रजातन्त्रात्मक- --- वि. --- प्रजा वा प्रजाद्वारा निर्वाचित प्रतिनिधिको शासन भएको; प्रजासत्तात्मक (राज्यव्यवस्था)।
प्रजातन्त्री- --- वि. --- हे. प्रजातान्त्रिक।
प्रजातन्त्रीकरण- --- ना. --- प्रजाद्वारा निर्वाचित प्रतिनिधिलाई शासनसत्ता सुम्पने कार्य; प्रजातन्त्र विकसित तुल्याउने क्रिया।
प्रजातान्त्रिक- --- वि. [सं.] --- प्रजातन्त्रको प्रजातन्त्रसम्बन्धी।
प्रजातान्त्रिक समाजवाद- --- ना. --- प्रजातान्त्रिक पद्धतिद्वारा निश्चित सीमा निर्धारित गरी कृषि, उद्योग र व्यापारमा होडबाजी गराएर क्रमशः सामाजिक परिवर्तन गर्दै समाजवादको स्थापना गर्ने कुरामा विश्वास राख्ने राजनीतिक सिद्धान्त; निम्न पुँजीवादी वा असाम्यवादी समाजवाद।
प्रजातान्त्रिक समाजवादी- --- वि. --- प्रजातान्त्रिक समाजवादमा विश्वास राख्ने; प्रजातान्त्रिक समाजवादको अनुयायी।
प्रजाति- --- ना. [सं.] --- १. एउटै मूल जातिभित्रका सानासाना जाति; एउटै जातिभित्रको अर्को जाति। २. प्राणी, वनस्पति आदिका प्रमुख जातिको कुनै शाखा।
प्रजाति सुजनन- --- ना. --- १. असल सन्तति जन्माउने क्रिया। २. असल प्रजाति पैदा गर्ने क्रिया।
प्रजाति संहार- --- ना. --- १. एउटै जातिअन्तर्गतका प्रजातिहरूमा परस्परमा आत्मश्रेष्ठताका भावनाले गर्दा उत्पन्न हुने जातीय भेदभाव। २. भिन्नभिन्न प्रजातिहरूका बिच व्यावहारिक प्रतिस्पर्धा पर्न गई एक प्रजातिद्वारा कुनै अर्काको संहार।
प्रजातीय- --- वि. [सं.] --- प्रजातिको; प्रजातिसम्बन्धी।
प्रजातीय गुण- --- ना. --- प्रजातिमा हुने गुण।
प्रजातीयता- --- ना. --- प्रजातीय हुनाको भाव, अवस्था वा लक्षण।
प्रजापति- --- ना. [सं.] --- १. प्रजाको मालिक; राजा। २. प्राजापत्यको मालिक; कविलाको नेता। ३. ब्रह्मा वा ब्रह्मर्षि।
प्रजापालक- --- वि. [सं.] --- १. प्रजालाई पालन गर्ने। ना. २. राजा। ३. प्रजापति।
प्रजावती- --- ना. [सं.] --- १. छोराछोरी भएकी स्त्री; सन्तान भएकी स्त्री। २. गर्भधारण गरेकी स्त्री; गर्भिणी।
प्रजासत्ता- --- ना. [सं.] --- प्रजातन्त्र; जनतन्त्र; गणतन्त्र।
प्रजासत्तात्मक- --- वि. --- प्रजातान्त्रिक; जनतान्त्रिक; गणतान्त्रिक।
प्रज्ञ- --- वि. [सं.] --- १. चतुर तथा बुद्धिमान्; जान्नेबुझ्ने। २. विद्वान्; पण्डित।
प्रज्ञता- --- ना. --- १. प्रज्ञ हुनाको भाव वा अवस्था; राम्रो ज्ञान। २. विद्वत्ता; पाण्डित्य।
प्रज्ञप्ति- --- ना. [सं.] --- १. जनाउने वा सूचित गर्ने काम। २. विज्ञप्ति; सूचना।
प्रज्ञा- --- ना. [सं.] --- १. नयाँ-नयाँ कुरा सोच्न सक्ने वा कल्पना गर्न सक्ने मानसिक शक्ति; गहिरो कुरा सोच्न सक्ने बुद्धि; विवेक। २. विशिष्ट ज्ञान।
प्रज्ञाकेन्द्र- --- ना. --- प्राज्ञिक परिषद्‌को सचिवालयका रूपमा काम गर्ने विश्वविद्यालयीय एक निकाय; विश्वविद्यालयमा पाठ्यक्रम, पाठ्यपुस्तक र शिक्षणपद्धतिको निर्माणजस्ता प्राज्ञिक कार्य गर्ने प्रशासनिक सङ्गठन।
प्रज्ञाचक्षु- --- ना. --- १. मानसिक दृष्टि प्रबल भएको व्यक्ति; प्रज्ञा नै आँखा भएको व्यक्ति; ज्ञानचक्षु। २. ठुलो विद्वान्; मेधावी। ३. अन्धो । ४. चर्मचक्षुका विपरीत अन्तरचक्षुः ज्ञानचक्षु।
प्रज्ञात- --- वि. --- विशेष रूपमा ज्ञात भएको वा जानिएको।
प्रज्ञापक- --- वि. [सं.] --- १. प्रज्ञापन गर्ने। २. सूचित गर्ने; विज्ञापक।
```
-------------------
