-------------------
```
पछारपुछुर --- ना. --- लुगाफाटो ढुङ्गामा बजार्ने काम।
पछारपुछुर- --- ना. --- राम्ररी पछार्ने काम (लुगा)।
पछाराइ- --- ना. --- १. पछार्ने क्रिया वा प्रक्रिया। २. पछारिने क्रिया वा प्रक्रिया।
पछारिनु- --- अ.क्रि. --- १. भुईंमा लड्नु; लोट्नु। क.क्रि. २. भुईंमा लडाइनु। ३. भिजेका लुगा ढुङ्गा आदिमा बजार्ने काम गरिनु।
पछि- --- ना. यो. [सं. पश्च+ई] --- १. पछिल्तिर; पछाडि । क्रि.वि. २. समय बिताएर, पछिबाट; ढिलो; पछाडि।
पछिउँदै उँडो- --- क्रि.वि. --- पछिबाट समय बिताएर; पश्चात्।
पछितो- --- ना. [√ पछुतो] --- पश्चात्ताप; पछुताउ; पछुतो।
पछिया- --- ना. [पश्चिम] --- पच्छिमतर्फबाट आउने बतास वा हावा।
पछिल्तिर- --- क्रि.वि. [पछि+तिर] --- १. पछाडिपट्टि; पिठिउँतिर। ना. यो. २. पछि; पछाडि ।
पछिल्लो --- वि. [पछि+लो] --- पछाडिपट्टिको; पछिल्तिरको; पिठिउँतिरको ।
पछुताइ- --- ना. [√ पछुताउ (+आइ)] --- पछुताउने भाव, क्रिया वा प्रक्रिया।
पछुताइनु- --- क.क्रि. --- पछुताउने काम गरिनु, पछुताउने पारिनु।
पछुताउ- --- ना. [पछुतो+आउ > सं. पश्चात्ताप] --- पश्चात्ताप; पछितो; पछुतो।
पछुताउनु- --- स.क्रि. --- भुलचुकमा भए-गरेका कामकुरामा दुःख मान्नु; पछुताउ गर्नु; पछुतो मान्नु; चुकचुकाउनु; थकथकाउनु।
पछुताहट --- ना. --- पछुताइ; पछुतो।
पछुतो- --- ना. [सं. पश्चात्ताप] --- पहिले आफूले गरेका भुलमा मानेको अफसोस; थकथकी; पश्चात्ताप; पछितो।
पछुवा- --- वि. [पछि+उवा] --- १. पछाडि रहेको; पछाडि परेको; पछि भएको। ना. २. हात्तीका सवारीमा पछाडिपट्टि बस्ने (माहुतेभन्दा तल्लो दर्जाको) व्यक्ति। ३. पोइल जाँदा आफ्ना पछि लागेर आएको; पहिलो लोग्नेतिरको पछिल्लो सन्तान। ४. गोरुगाडा आदि सङ्कटमा पर्दा बैलवानलाई सहायता गर्न पछि लाग्ने व्यक्ति।
पछुवा- --- ना. [सं. पश्चवात] --- पश्चिमतिरबाट पूर्वतिर बगेको हावा; लु।
पछेउरा- --- ना. --- हे. पछ्‌यौरो।
पछेउरो --- ना. --- पछ्‌यौरी।
पछेउरो- --- ना. --- पछ्‌यौरो।
पछेटा/पछेटो- --- ना. [सं. पश्च+एटा/एटो] --- पछि लाग्ने काम; पछ्याउने काम; पिछा; अनुसरण।
पछेनी- --- ना. [सं. पक्ष्म > फा. पशम एनी] --- १. पस्मिनाको फेटा। २. फेटा।
पछोड- --- ना. [सं. पश्च ओड] --- कडी लगाएर हात्तीका पछिल्तिर कसिने डोरी।
पछौटे- --- वि. [सं. पश्च+औटे] --- १. पछि परेको; पछाडिको। २. अविकसित। ३. पछाडि पाक्ने वा पछाडि फल्ने (बाली, फल आदि); पछुतिया। ४. पछि लाग्ने; पछ्याउने (व्यक्ति)। ५. पछि बियाउने (गाई आदि)।
पछौटो- --- ना. [पछि+औटो] --- १. सबभन्दा पछि जन्मिएको सन्तान। २. कुनै काममा सबभन्दा पछि परेको व्यक्ति। ३. सबैभन्दा पछिको उब्जा।
पद्धतिया- --- वि. [सं. पश्चात्+इया] --- पछि पाक्ने वा तयार हुने (बाली, फल आदि)।
पछ्याइ- --- ना. [√ पछ्‌याउ (+आइ)] --- पछ्याउने क्रिया वा प्रक्रिया।
पछ्‌याइनु- --- क.क्रि. --- पछ्‌याउने काम गरिनु; पछि लागिनु।
पछ्‌याउनु- --- स.क्रि. [पछि+आउ+नु] --- १. पछि लाग्नु; पिछा गर्नु। २. केटाकेटी वा पशुले माया गरेर पछि लाग्नु; रत्तिनु। ३. कसैका सँगसँगै काम गर्नु; पछिपछि गर्दै जानु।
पछ्‌यौरा --- ना. [सं. पक्ष्म+यौरा] --- पछ्‌यौरो; पछेउरा।
पछ्‌यौरी- --- ना. --- पछ्‌यौरो।
पछ्‌यौरो- --- ना. --- फेर मार्न वा फन्को मार्नसमेत हुने किसिमको ओढ्ने वस्त्र; दुपट्टा; उत्तरीय वस्त्र (खास्टो, बर्को आदि)।
पजनी- --- ना. [फा. पा+जनी] --- सरकारी तहका कर्मचारीहरूको काम गराइको इमानदारी वा बेइमानीका आधारमा खारेजी, सरुवा, थमौती, बढुवा आदि गर्ने काम।
पजनी कागज/कागत- --- ना. --- सरकारी कर्मचारीको कामअनुसार थमौती, खारेजी, सरुवा, बढुवा आदिका निम्ति तिनले गरेका काम आदिको विवरणसमेत तयार पारिएको कागज।
पजलो- --- ना. [पन्जा+लो] --- १. सम्म परेको जमिन; समतल भूमि। वि. २. समथर; पँजलो।
पञ्च- --- ना. [सं.] --- १. पाँचको सङ्ख्या। २. पाँच वा त्यसभन्दा बढी भलादमीहरूको समुदाय; पञ्चभलादमी। ३. पञ्चभलादमीमध्ये एक। ४. पञ्चायतको सदस्य।
पञ्चक- --- ना. --- १. एकै प्रकारका पाँच वस्तुहरूको समुदाय। २. धनिष्ठादेखि रेवतीसम्मका पाँच नक्षत्र। ३. कार्तिक कृष्ण त्रयोदशीदेखि शुक्ल द्वितीयासम्मका पाँच दिन; यमपञ्चक । ४. कार्तिक शुक्ल एकादशीदेखि पूर्णिमासम्मका पाँच दिनको समय; भीष्मपञ्चक। वि. ५. पाँच अङ्कको।
पञ्च कचहरी --- ना. --- पञ्चभलादमीहरू बसेर गरिएको कुनै विषयको छलफल।
पञ्चकन्या- --- ना. --- अहल्या, द्रौपदी, तारा, कुन्ती र मन्दोदरी गरी जम्मा पाँचवटी कन्याहरूको समुदाय।
पञ्चकर्म- --- ना. --- जप, होम, तर्पण, रुद्राभिषेक र ब्राह्मणभोजन यी पाँच पुण्य कर्म।
पञ्चकिर्ती/किर्ते --- वि. --- पञ्चभलादमीले ठहराएको; पञ्चले निर्णय गरेको (मोल)।
पञ्चकिर्ते मोल- --- ना. --- पञ्चभलादमीले ठहराएको वा निर्णय गरेको मोल ।
पञ्चकृति- --- वि. --- पञ्चकिर्ते।
पञ्चक्लेश- --- ना. --- योगशास्त्रअनुसार अविद्या, अस्मिता, राग, द्वेष र अभिनिवेश गरी जम्मा पाँच प्रकारका क्लेशहरू।
पञ्चखत- --- ना. --- साबित भएमा ज्यान सजाय हुने, दामल हुने, मुडिने, घटी जातमा मिलाई खोपिने र जात पतित हुने- यी पाँच किसिमका
पञ्चगव्य --- ना. --- गाईको दुध, दही, घिउ, गउँत र गोबर मिलाई पूजादि कार्यका निम्ति बनाइएको पवित्र वस्तु।
पञ्चगुण- --- ना. --- १. शब्द, स्पर्श, रूप, रस र गन्ध- यी पाँच प्रकारका गुण। वि. २. पाँच गुना; पाँच दोब्बर।
पञ्चगौड- --- ना. --- विन्ध्याचलका उत्तरी भागमा बस्ने सारस्वत, कान्यकुब्ज, गौड, मैथिल र औत्कल गरी ब्राह्मणका पाँच वर्ग।
पञ्चचामर- --- ना. --- प्रत्येक चरणमा लघुगुरु मात्रा हुने सोह्र-सोह्र अक्षरका चार चरण हुने वार्णिक छन्द।
पञ्चतत्त्व- --- ना. --- १. पृथ्वी, जल, तेज, वायु र आकाश गरी जम्मा पाँच प्राकृतिक तत्त्व । २. पञ्चमकार।
पञ्चतन्त्र- --- ना. --- नीतिसम्बन्धी उपदेशप्रद कथाहरूलाई पाँचोटा मूल कथामा उनेर लेखिएको प्रसिद्ध ग्रन्थ।
पञ्चतारा- --- ना. --- १. ध्यानी बुद्धका पाँच शक्ति। २. पञ्चबोधिसत्त्वकी माता। ३. वज्रधात्वीश्वरी, लोचना, मामकी, पाण्डुरा र तारा गरी जम्मा पाँच बौद्ध शक्ति।
पञ्चताल- --- ना. --- मादलसँग मिल्दो एक नेपाली बाजा।
पञ्चदश- --- ना. --- दश र पाँचको योगबाट बनेको सङ्ख्या; पन्ध्रको सङ्ख्या।
पञ्चदशी- --- ना. --- १. पूर्णिमा तिथि। २. वेदान्तको एक प्रसिद्ध ग्रन्थ।
पञ्चद्रविड- --- ना. --- १. विन्ध्यापर्वतका दक्षिण भागमा बस्ने, महाराष्ट्र, तैलङ्ग, गुर्जर र द्रविड गरी जम्मा पाँच ब्राह्मणवर्गको समुदाय। २. विन्ध्यापर्वतभन्दा दक्षिणतिर बोलिने तामिल, कन्नड, तेलगु, मलयालम र सिंहली मैं पाँच प्रधान भाषा।
पञ्चध्यानी बुद्ध- --- ना. --- वैरोचन, अक्षोभ्य, रत्नसम्भव, अमिताभ र अमोघसिद्धि गरी जम्मा पाँच बुद्ध।
पञ्चनख- --- वि. --- १. पाँच नङ हुने (जीव)। २. हात्ती। ३. कछुवा। ४. बाघ।
पञ्चनद- --- ना. --- १. पन्जाब प्रदेशमा बग्ने झेलम, व्यास, राबी, चिनाव र सतलज- यी पाँच नदीहरूको समूह। २. पन्जाब प्रदेश। ३. किरण, धूतपापा, सरस्वती, गङ्गा र यमुना- यी पाँच नदीहरूको समुदाय।
पञ्चनिर्णय- --- ना. --- पञ्चद्द्वारा गरिएको निर्णय।
पञ्चन्यायाधिकरण- --- ना. --- पञ्चभलादमीहरूद्वारा गठन गरिएको तल्लो तहको अदालत; पञ्चायती अदालत।
पञ्चपखान- --- ना. --- छताछुल्ल भएर छरिएको वा पोखिएको वस्तु।
पञ्चपखाल- --- ना. --- १. ज्यादै पातलो दिसा; पखाला। २. छताछुल्ल भएर छरिएको वा पोखिएको पन्यालो वस्तु; पञ्चपखान।
पञ्चपर्व- --- ना. --- अष्टमी, चतुर्दशी, पूर्णिमा, अमावास्या र रविसङ्क्रान्ति गरी पाँचवटा पर्व।
पञ्चपाण्डव- --- ना. --- पाण्डुका पाँच छोराहरू; युधिष्ठिर, भीमसेन, अर्जुन, नकुल र सहदेव गरी महाभारतप्रसिद्ध पाँच पुरुष।
पञ्चपात्र- --- ना. --- देवादिको कार्यमा प्रयोगमा ल्याइने दुई जलपात्र, दुई आचमनी र एक थाली गरी जम्मा पाँच पात्र।
पञ्चपाला- --- ना. --- १. प्रायः पाँचदेखि सात खण्डसम्म भएको पूजाको सामग्री हाल्ने, धातुबाट बनेको विशेष प्रकारको थाली। २. धेरै खण्ड भएको काठ, माटो आदिबाट बनेको मरमसला राखिने भाँडो; सन्जोगे।
पञ्चपिता- --- ना. --- जन्म दिने (बाबु), मन्त्र दिने (गुरु), कन्या दिने (ससुरो), अन्न दिने (किसान) र भय हर्ने (राजा) गरी जम्मा पाँच प्रकारका पिता।
पञ्चप्राण- --- ना. --- प्राण, अपान, व्यान, उदान र समान गरी जम्मा पाँच प्रकारका वायु; शरीरमा रहने पञ्चवायु।
पञ्चबुद्ध- --- ना. --- १. वैरोचन, अक्षोभ्य, अमिताभ, रत्नसम्भव र अमोघसिद्धि गरी अलौकिक शक्ति भएका जम्मा पाँच बुद्ध। २. पुराणप्रसिद्ध पाँच बुद्धहरूको समूह (विपस्वी, शिखी, क्रकुच्छन्द, कनकमुनि र काश्यप)।
पञ्चबोधिसत्त्व - --- ना. --- १. समन्तभद्र, वज्रपाणि, रत्नपाणि, पद्मपाणि र विश्वपाणि गरी जम्मा पाँच बोधिसत्त्व । २. पञ्चध्यानी बुद्धका छोरा। ३. पञ्चताराका छोरा।
पञ्चभलादमी- --- ना. --- गाउँका पाँच वा त्यसभन्दा बढी गण्यमान्य व्यक्तिहरूको समुदाय।
पञ्चभेला --- ना. --- पञ्चायतका सबै तहका सदस्यहरूको एकत्रित समूह, जमघट वा महासम्मेलन।
पञ्चम- --- वि. --- १. पाँचौं । ना. २. सङ्गीतका सात स्वरमध्ये एक। (यसलाई सङ्क्षेपमा 'प' भनिन्छ र यसमा ३६० नादलहरी रहेका हुन्छन्)।
पञ्चमकार- --- ना. --- वाममार्गीहरूका मतअनुसार मद्य, मांस, मत्स्य, मुद्रा र मैथुन- यी पाँच शब्दका सुरुसुरुका पाँचोटा म; यी पाँच मकारबाट बन्ने वस्तु।
पञ्चमहापातक- --- ना. --- ब्रह्महत्या, सुरापान, चोरी, गुरुस्त्रीगमन र ती चार महापातकीको सहवास गरी पाँच किसिमका पातक वा पाप।
पञ्चमहाभूत- --- ना. --- पृथ्वी, जल, तेज, वायु र आकाश- यी पाँच तत्त्व ; पञ्चतत्त्व ।
पञ्चमहायज्ञ- --- ना. --- स्वाध्याय (ब्रह्मयज्ञ), होम (देवयज्ञ), वलिवैश्वदेव (भूतयज्ञ), पिण्डक्रिया (पितृयज्ञ) र अतिथिपूजा (नृयज्ञ) गरी जम्मा पाँच किसिमका यज्ञ; गृहस्थीका घरमा नित्य रूपले गरिने उपर्युक्त पाँच महायज्ञ।
पञ्चमहाव्याधि- --- ना. --- अर्श, यक्ष्मा, कुष्ठ, प्रमेह र उन्माद गरी जम्मा पाँच किसिमका भयानक रोग।
पञ्चमहाव्रत- --- ना. --- अहिंसा, सुनृता (मिठो वा साँचो बोली), अस्तेय (चोरी नगर्नु), ब्रह्मचर्य र अपरिग्रह (दान नलिनु वा सङ्ग्रह नगर्नु) जस्ता मनुष्यलाई माथिल्ला तहमा पुऱ्याउने मानिएका योगशास्त्रमा उल्लिखित जम्मा पाँचोटा महाव्रत।
पञ्चमाङ्ग- --- ना. [सं.] --- १. आधुनिक राजनीतिमा शत्रुका राज्यमा उपद्रव मच्चाउन र त्यहाँको गोप्य रहस्य थाहा पाउनका निम्ति तयार पारिएको वा नियुक्त गरिएको विशेष प्रकारको दल। २. स्वदेशका विरुद्ध विदेशको दलाली गर्ने दल वा व्यक्ति ।
पञ्चमाङ्गी- --- वि. --- १. पञ्चमाङ्गको; पञ्चमाङ्गसम्बन्धी। ना. २. पञ्चमाङ्ग।
```
-------------------
