-------------------
```
पटयाँस --- ना. [अ.मू. पटयाँस्+अ] --- चामल आदि निफन्दा औंलाले हान्दा नालाबाट निस्कने शब्द।
पटयाँस- --- ना. [सं. पटांश] --- बाँसका हरेक आँख्लामा बेरिएर पलाउने झुसैफुस भएको, फुकाएर फराकिलो पारी लेख्ने काममा र पड्या आदि बनाउने काममा प्रयोग गर्न सकिने वस्तु; बाँसको खपटा।
पट्याइ- --- ना. [√ पट्याउ (+आइ)] --- पट्याउने भाव, क्रिया वा प्रक्रिया; पट्ट्याइ।
पट्याइनु- --- क.क्रि. --- कागज, कपडा आदि तहैतह पारी दोब्याइनु; पट्याइनु; पट्याउने काम गरिनु।
पट्याउनु- --- स.क्रि. [स. पत्र+याउ+नु] --- कागज, कपडा आदि तहैतह पारेर दोब्याउनु; दोबर-तेबर आदि पार्दै तह लगाउनु; पट्ट्याउनु।
पट्याक- --- ना. [अ.मू. पट्याक्+अ] --- पड्कने वा भाँचिने चाल।
पट्याकपुटुक- --- ना. --- १. कडा र साना काठ भाँच्दा आउने शब्द। क्रि.वि. २. त्यस्ता काठहरू भाँच्दा शब्द गर्ने किसिमले। ३. हाँडीमा भुटिँदै गरेका मकै आदि फूल उठ्दै गर्ने गरी। ४. आगामा सेकाइएका दुधे मकै आदि शब्द निस्कने गरी पड्किँदै गरेर।
पट्याकपुटुक्क- --- क्रि.वि. --- पट्याकपुटुक हुँदै।
पट्याक्क- --- क्रि.वि. --- १. कडा र सानो काठ भाँच्ता एकाएक शब्द आउने किसिमले। २. पड्का आदि पड्कँदा एक्कासि शब्द निस्कने गरी। ३. औंला पड्‌काउँदा एक्कासि शब्द गर्ने किसिमसँग।
पट्याङ- --- ना. [अ.मू. पट्याङ्+अ] --- हे. पट्याक।
पट्याङपुटुङ- --- ना. / क्रि.वि. --- पट्याकपुटुक।
पट्याङ्ग/पट्याङ- --- क्रि.वि. --- पट्याङको ठुलो आवाज आउने गरी; पट्याक्क।
पट्यार- --- ना. [सं. प्रतिहार] --- १. कुनै काम गर्दा अनुभव हुने उराठ स्थिति। २. सधैं एकै ठाउँमा बसिरहँदा अनुभव हुने दिग्दारी। ३. पखँदा, कुर्दा वा पालो बस्दा लाग्ने अल्छी वा उँघाइ।
पठन- --- ना. [सं.] --- १. पढ्ने काम; अध्ययन। २. उल्लेख।
पठनपाठन- --- ना. --- पढ्ने र पढाउने काम; अध्ययन-अध्यापन; लेखपढ।
पठनशील- --- वि. --- खुब पढ्ने; अध्ययनशील।
पठनीय- --- वि. --- पढ्न योग्य; पाठ गर्न लायक; अध्ययनीय; पाठ्य।
पठाइ- --- ना. [√ पठाउ+आइ] --- पठाउने क्रिया वा प्रक्रिया।
पठाइनु- --- क.क्रि. --- १. पठाउन लाइनु। २. पठाउने काम होइनु। ३. पुऱ्याउन लाइनु।
पठाउनु- --- स.क्रि. / प्रे.क्रि. [सं. प्रस्थापन > प्रा. पट्ट्ठावण] --- १. कुनै ठाउँमा जान प्रेरणा दिनु, कतै पुग्न आज्ञा दिनु। २. कसैलाई कुनै ठाउँमा कुनै वस्तु पुऱ्याउन लगाउनु। ३. बिदा गर्नु; अन्माउनु। ४. लुर्काउनु। ५. प्रेषित गर्नु।
पठार- --- ना. [सं. प्रस्थाकर] --- समतल जमिनमा रहेका साना पर्वतशिखरहरूको बराबर उचाइमा रहेको हिमाल आदिका बिचमा परेको विस्तृत मैदान।
पठित- --- वि. [सं.] --- १. पढे-लेखेको; साक्षर। २. विद्या हासिल गरेको; शिक्षित।
पढाइनु ---  --- लगाइएको कुनिउँमा गुम्स्याएर तयार भएको हकुवा धान।
पठेग्री/पठेग्रो/पठ्याङ्ग्री/पठ्याङ्ग्रो- --- ना. [पाठो+एग्री/एग्रो/ याङ्ग्री/याङ्ग्रो] --- दुध छाडिसकेको र चर्ने अवस्थामा पुग्न लागेको, भेडा-बाख्राको पाठो ।
पड्नु- --- अ.क्रि. [सं. पतन] --- १. उपयोगमा नआई रहिरहनु; मिल्किएजस्तो भइरहनु। २. ढल्कनु; पल्टिनु।
पडताल- --- ना. [सं. परितोलन] --- कुनै काम-कुरामा रहेका खोट वा त्रुटिहरूको निरीक्षण वा जाँचबुझ गर्ने काम।
पडनी- --- ना. [पडता+नी] --- १. सुक्खा खेतमा पनि हुने एक प्रकारको चाँडै पाक्ने अग्निया धान। २. एक प्रकारको अघैया धान; धैया।
पडाइ- --- ना. [√ पड् (+आइ)] --- पड्ने क्रिया वा प्रक्रिया।
पडाइनु- --- क.क्रि. --- पड्ने तुल्याइनु।
पडाउनु- --- स.क्रि. / प्रे.क्रि. --- पड्ने तुल्याउनु।
पडिनु- --- अ.क्रि. --- उपयोगमा नआई त्यसै रहिरहनु; मिल्किनु।
पडुवा- --- वि. --- उपयोगमा नआई त्यसै रहिरहेको; मिल्किए बराबर भएको।
पड्कनु- --- अ.क्रि. [अ.मू. पडक्+नु] --- हे. पट्कनु।
पड्का- --- ना. --- पट्का।
पड्काइ- --- ना. --- पड्कने क्रिया वा प्रक्रिया।
पड्काइनु- --- क.क्रि. --- पट्काइनु।
पड्काउनु- --- स.क्रि. --- पट्‌काउनु।
पड्ङ्कार्नु- --- स.क्रि. --- हे. पट्कार्नु ।
पड्कारो/पकालो- --- वि. [सं. स्पष्टकर] --- पट्कारो।
प‌ड्किनु- --- अ.क्रि. --- हे. प‌ट्किनु ।
पड्के- --- वि. / ना. --- १. हे. पट्के। २. सेता भावका खस्रा, तीन- चार अमल चौडा पात हुने र सेतो बोक्रो हुने पड्याक्क भाँचिने खालको दुब्लो काठ हुने एक जातको रुख। ३. पशु।
पड्को- --- ना. [पड्क+आ] --- पड्याक्क भाँचिने खालको; कमजोर वा कमलो (रुख, काठ आदि)।
पड्क्याइ- --- ना. [√ पङ्कि (+याइ)] --- पड्किने भाव, क्रिया वा प्रक्रिया।
पड्ङ्क्याहट- --- ना. --- पड्किने भाव, अवस्था वा क्रिया-प्रक्रिया।
पड्याक- --- ना. [पड्याक्+अ] --- पड्कँदा वा भाँचिंदाको शब्द।
पड्याकपुडुक- --- ना. / क्रि.वि. --- हे. पट्याकपुटुक ।
पड्याक्क- --- क्रि.वि. --- हे. पट्याक्क।
पड्याङ- --- ना. [अ.मू. पट्याङ्+अ] --- हिर्काइको चाल वा शब्द।
पड्याङपुडुङ- --- क्रि.वि. --- पड्याङको शब्द निकालिरहेर।
पड्याङ्ग/पड्याङ- ---  --- १. बन्दुक आदि वस्तु पड्कने किसिमले पट्याङ; पट्याक। २. गालामा लबटाले हान्दा शब्द निस्कने गरी।
पढ्नु- --- स.क्रि. [सं. पठनु] --- १. पुस्तक वा लेखमा लेखिएका कुराको ज्ञान हुने गरी पाठ गर्नु; पाठ घोक्नु; विद्याभ्यास गर्नु; अध्ययन गर्नु। २. बाच्नु; पाठ गर्नु। ३. सिक्नु; जान्नु।
पढन्त/पढन्ते- --- वि. --- आवश्यकभन्दा बढी पढ्ने; खुब पढ्ने; सधैं एकनाससित पढिरहने।
पढाइ- --- ना. --- पढ्ने भाव, क्रिया वा प्रक्रिया।
पठुवा- --- ना. [ > पडुवा] --- खेतमा रहलपहल हरिया बोट सोहोरेर | पढाइनु- क.क्रि. पढ्न लाइनु; शिक्षा दिइनु।
पढाउनु- --- प्रे.क्रि. --- १. पुस्तक वा लेखमा लेखिएका कुराको बोध गराउनु; पुस्तकका कुरा बुझाउनु। २. विद्याभ्यास गराउनु; विद्या हासिल गराउनु। ३. ज्ञान गराउनु; सिकाउनु।
पढिनु- --- क.क्रि. --- पढ्ने काम गरिनु।
पढीपण्डित- --- ना. --- पढेर भएको पण्डित।
पढैया - --- वि. --- पढिरहने; रटन्ता; अध्ययनशील।
पण- --- ना. [सं.] --- १. बाजी राखेर खेलिने खेल। २. बाजी राखिएको वस्तु। ३. ज्याला; मजदुरी; पारिश्रमिक । ४. इनाम; पुरस्कार; पारितोषिक। ५. रुपियाँ; पैसा। ६. प्रतिज्ञा; कबुल; सर्त। ७. लिच्छविकालीन तामाको मुद्रा।
पणक्रिया- --- ना. --- बाजी थाप्ने वा बाजी लगाउने काम।
पणबन्ध - --- ना. --- १ बाजी। २. प्रतिज्ञा।
पण्डा- --- ना. [सं.] --- १. सत् र असत् कुराको विवेक गर्ने बुद्धि; विवेकशक्ति। २. विद्या; ज्ञान। ३. तीर्थ, मन्दिर वा घाटमा धार्मिक कृत्य गराउने ब्राह्मण; तीर्थ-पुरोहित; गङ्गापुत्र।
पण्डित- --- ना. [सं.] --- १. शास्त्रको तात्पर्य राम्ररी बुझेको विद्वान् व्यक्ति; शास्त्रवेत्ता। २. सत् र असत् छुट्ट्याउने बुद्धि भएको व्यक्ति। ३. संस्कृतको वा अन्य भाषाको विद्वान् व्यक्ति। ४. ब्राह्मणलाई आदर गर्दा भनिने शब्द। ५. राणाकालमा चलेको शिक्षकहरूको एक दर्जा। ६. घृतकौशिक गोत्रका नेपाली बाहुनहरूको एक थर। वि. ७. विद्वान्; शास्त्रज्ञ। ८. निपुण; कुशल । ९. पुराण भन्ने; पौराणिक।
पण्डितमानी - --- वि. --- आफूलाई सबैभन्दा ठुलो विद्वान् ठान्ने।
पण्डितराज- --- ना. --- १. ठुला विद्वान् वा धुरन्धर पण्डित। २. त्यस्ता ठुला विद्वान् पण्डितलाई दिइने एक उपाधि।
पण्डित्याइँ- --- ना. --- पण्डितमा रहने गुण; पाण्डित्य; विद्वत्ता।
पण्ढ- --- वि. [सं.] --- १. खरिदबिक्री गर्न योग्य। ना. २. खरिदबिक्री गरिने वस्तु। ३. खरिदबिक्री गरिने ठाउँ; बजार। ४. खरिदबिक्री गर्ने साधन; पण; मुद्रा।
पण्ढक्षेत्र- --- ना. --- मालसामानहरू खरिदबिक्री गरिने ठाउँ; बजार; हाट; पण्यभूमि।
पण्ढदासी- --- ना. --- पैसा लिएर अर्काको नोकरी गर्ने स्त्री।
पण्ढभूमि- --- ना. --- पण्ढक्षेत्र।
पण्ढवीथि - --- ना. --- हाट; बजार; पसल।
पण्ढशाला- --- ना. --- खरिदबिक्री गर्ने दुकानहरू भएको घर; पसल।
पतकर- --- ना. [सं. पत्रकृत] --- हे. पत्कर।
पतङ्ग- --- ना. [सं.] --- १. पक्षी; चरो। २. उड्ने पुतली। ३. फट्याङ्ग्रो। ४. चङ्गा।
पतङ्गिका- --- ना. --- १. सानो आकारको एक जातको पक्षी। २. मौरी। ३. उड्ने पुतली।
पतझर- --- ना. [सं. पत्र+प्रा. झड] --- शिशिर वा अन्य कुनै ऋतुमा रुखबाट पात झर्ने निखुर्को।
पतझर वन- --- ना. --- सदाबहार नभई शिशिर वा अन्य कुनै ऋतुमा पात झरेर नाङ्गिएका रुख भएको जङ्गल।
पतञ्जलि - --- ना. [सं.] --- महाभाष्य नामक व्याकरण वा भाषाशास्त्रको रचना गर्ने पाणिनीय परिपाटीका मुनि; नागेश; फणीन्द्र।
पतन- --- ना. [सं.] --- १. माथिबाट तलतिरको खसाइ; गिराइ। २. उन्नति, वैभव, पद मर्यादा आदिबाट तल झरेको अवस्था; अवनति। ३. जातिच्युत हुने वा भएको अवस्था। ४. नाश; विध्वंस। ५. मृत्यु; मरण।
पतनशील- --- वि. --- पतन हुँदै गएको; पतनोन्मुख।
पतनीय- --- वि. --- पतन हुन सम्भावित वा स्वाभाविक; पतन हुने अवस्थामा पुगेको र खस्न वा झर्न लायक।
पतनोन्मुख- --- वि. --- पतनतिर उन्मुख भएको; पतन हुन लागेको; खस्न आँटेको; पतनशील।
पतपत- --- क्रि.वि. [अ.मू. पत्+अ (द्वि.)] --- १. गिलो वा पातजस्तो हलुका वस्तु लगातार खस्ने गरी; त्यसरी खस्ता शब्द निस्कने गरी। २. धुवाँ निस्कने किसिमले; पुतपुत।
पतपती- --- क्रि.वि. --- अझै पतपत हुने गरी।
पतरी- --- ना. [पातर+ई] --- वेश्या; पातर।
पतरी- --- ना. [पात+अरी] --- १. टपरी। २. साहै पुरानो भई टालेको कपडा।
पतला - --- वि. [सं. पत्राल] --- पातलो।
पतलाइ- --- ना. [√ पतलाउ (+आइ)] --- पतलाउने क्रिया वा प्रक्रिया।
पतलाइनु- --- अ.क्रि. --- पातलो होइनु।
पतलाउनु- --- अ.क्रि. [पातलो+आउ+नु] --- पातलो हुनु; दुब्लाउँदै जानु।
पतलुन- --- ना. [अड्. पैन्टलून] --- खुकुला र सोझा मोहोता हुने, इँजार नहाली टाँक आदि लगाइने एक प्रकारको युरोपेली सुरुवाल।
पतल्याइ- --- ना. [√ पतल्याउ (+आइ)] --- पतल्याउने क्रिया वा प्रक्रिया।
पतल्याइनु- --- क.क्रि. --- पातलो पारिनु; पातलो बनाइनु।
पतल्याउनु- --- स.क्रि. [पातलो+याउ+नु] --- १. पातलो पार्नु, पतन बनाउनु। २. पन्यालो तुल्याउनु; तरल बनाउनु। ३. काठ आदिलाई खुर्केर वा ताछेर पातलो पार्नु।
पतल्याहट - --- ना. --- पतल्याइ।
पतवार ना. [प्रा. पात्तवाड८ सं. पत्रवाल] --- १. नाउ ल्याउने दाबिलोजस्तो साधन; बहना। २. नाउलाई यताउति घुमाउन नाउका पछिल्तिर लगाइने साधनविशेष; पछवार।
पतही- --- ना. [सं. पत्र + ई] --- हे. पतै।
पता- --- ना. [सं. प्रस्थ = बस्ती] --- १. व्यक्तिविशेषको बसोबास भएको ठाउँ-ठेगाना; वतन। २. चिठी आदि ठिक ठाउँमा पुऱ्याउनका निम्ति खामका बाहिरपट्टि लेखिने नाम, ठाउँ आदि। ३. परिस्थितिको वा कुनै विषयका रहस्यको ज्ञान; पत्तो।४. रहस्य; भेद, भेउ। ५. ज्ञान।
पताका- --- ना. [सं.] --- १. झन्डा वा ध्वजा। २. चिह्न वा निसान। ३. साहित्यमा नाटकको मूल कथावस्तुदेखि अतिरिक्त सहायक कथा हुने विशिष्ट स्थल; पताकास्थानक।
पताकास्थानक- --- ना. --- विचार गरिएको विषय वा प्रस्तुत प्रसङ्गसँग मेल खाने अर्को विषय वा प्रसङ्ग उपस्थित हुने नाटकको स्थल।
पताकी- --- वि. --- १. पताका भएको, झन्डावाल। २. पताका लिने; झन्डा बोक्ने। ना. ३. रथ।
```
-------------------
