-------------------
```
हिमालय पर्वत --- ना. --- खरीमाटो वा खरीढुङ्गाको युगमा सृष्टि भएको पर्वत; आजभन्दा लगभग तेह्र करोड पचास लाख वर्षपहिले सृष्टि भएको पहाड; हिमालय।
हिमाली- --- वि. [हिमाल ई] --- हिमालमा रहने; हिमालको; हिमालसम्बन्धी।
हिमाली गिद्ध- --- ना. --- हिमालय पर्वतको आसपासमा पाइने गिद्ध।
हिमाली भाषा- --- ना. --- भोट-बर्मेली शाखाको, भोट-हिमाली वर्गको एउटा भेद।
हिमैकड्‌मो- --- ना. --- नेपालको सङ्खुवासभा जिल्लामा पाइने डाँफेभन्दा ठुलो एक जातको हिमाली लुइँचे चरो।
हिमोट- --- ना. [हिम+ओट] --- हिमनदीले सोहोरेर ल्याएको माटो, बालुवा, ढुङ्गा र झारपात आदि वस्तु।
हिम्मत- --- ना. [अ.] --- १. कठिन काम गर्ने उत्साह वा साहस; हिक्मत। २. पराक्रम; सुऱ्याइँ; बहादुरी।
हिम्मतदार --- वि. --- हिम्मत भएको; आँट गर्ने; उत्साही।
हिम्मतहारा --- वि. --- हिम्मत नभएको; निरुत्साही।
हिम्मती- --- वि. --- हिम्मतदार।
हियरा- --- ना. [सं. हृदय] --- १. हृदय; मुटु; मन। २. छाती; वक्षस्थल। ३. स्तन; दुध।
हियाइ- --- ना. [√ हियाउ (+आइ)] --- हियाउने भाव, क्रिया वा प्रक्रिया।
हियाइनु- --- क.क्रि. --- हियाउने काम गरिनु।
हियाउ- --- ना. [हियो+आउ] --- १. आँट; हिम्मत; उत्साह; ह्याउ। २. हृदय; मन।
हियाउनु- --- स.क्रि. [हेय+आउ+नु] --- हेला वा अपमान गर्नु; हेय गराउनु; हेप्नु; ह्याउनु।
हियार- --- ना. [सं. हृदय] --- हृदय; हियरा।
हियारो- --- ना. --- मुटु; हियो; हृदय।
हियो- --- ना. [प्रा. हिअअ८ सं. हृदय] --- हृदय; मुटु; मन।
हिरण- --- ना. [सं.] --- १. सुन; सुवर्ण। २. वीर्य। ३. कौडो।
हिरण्मय- --- वि. --- १. सुनबाट बनेको; सुनको। २. सुनौला; स्वर्णमय। ना. ३. हिरण्यगर्भ; ब्रह्मा।
हिरण्य- --- ना. [सं.] --- १. सुन; सुवर्ण; स्वर्ण। २. ब्रह्मा।
हिरण्यकशिपु- --- ना. --- १. कश्यप प्रजापतिका छोरा, पुराणप्रसिद्ध दैत्यराज। २. सुनको पलङ।
हिरण्यगर्भ- --- ना. --- १. नेपालको कृष्णगण्डकीमा पाइने शालिग्रामशिला। २. ब्रह्मा। ३. विष्णु। ४. फलामजस्तो एक प्रकारको घाउ। ५. उपनिषद्‌का अनुसार सम्पूर्ण पदार्थ र जीवहरूको मूल उद्गमस्थल भएको सृष्टिको प्रारम्भमा रहेको सुनौला रङ्गको पिण्ड।
हिरण्यनाभ- --- ना. --- १. विष्णु। २. मैनाकपर्वत।
हिरण्याक्ष --- ना. --- पुराणप्रसिद्ध एक दैत्य; हिरण्यकशिपुको दाजु।
हिरन- --- ना. [सं. हिरण] --- १. मर्न लागेका बिरामीलाई खुवाइने सुनपानी, दही आदि पदार्थ। २. भात आदि खानेकुरो (रिस वा गालीका रूपमा)।
हिले- --- वि. [हिलो+ए] --- १. हिलोमा हुने वा पाइने; हिलाको; हिलोसम्बन्धी। ना. २. रोपाइँ गर्दा परस्परमा हिलो छ्यापाछ्‌याप गरेर खेलिने खेल।
हिले जात्रा- --- ना. --- गाईजात्राको भोलिपल्ट रोपाइँको अभिनय गरेर देखाइने जात्रा; रोपाइँजात्रा।
हिले पालुङ्गो- --- ना. --- पालुङ्गोभन्दा लामा पहेंल्छ्या पात र फुस्रो डाँठ हुने पालुङ्गो; गोब्रे पालुङ्गो।
हिले फागु- --- ना. --- अबिरको सट्टा हिलो घस्नेछ्याप्ने गरेर खेलिने खेल वा त्यस्तो फागुजात्रा।
हिले माछो --- ना. --- हिलामा वा मैलो पानीमा बस्ने माछो।
हिलो- --- ना. [प्रा. हिल] --- पानीमा मुछिएको माटो; माटाको लेदो; पङ्क।
हिल्याइ- --- ना. [√ हिल्याउ (+आइ)] --- हिल्याउने भाव, क्रिया वा प्रक्रिया।
हिल्याइनु- --- क.क्रि. --- हिल्याउने काम गरिनु, हिलो पारिनु।
हिरा- --- ना. [सं. हीरक] --- पुरानो कोइलाखानीको आसपासमा पाइने, अति साह्रो र सानमा चढाएपछि अन्धकारमा पनि उज्यालो चमक दिने बहुमूल्य रत्न; हीरक।
हिराकसी- --- ना. --- गन्धकको रासायनिक प्रक्रियाबाट तयार हुने फलामको विकार।
हीरावली- --- ना. --- प्रायः बिछ्‌याउने काम लिइने, देख्दा राम्रो, चारखाने खस्रो कपडा।
हिरासत- --- ना. [अ.] --- १. अपराधीलाई निश्चित वा अनिश्चित समयसम्म थुन्ने काम; कैद; थुना; नजरबन्दी। २. बन्दीखान; झ्यालखान; खोर। ३. सिपाही वा पुलिसको रेखदेख, पहरा।
हिरिक्क- --- क्रि.वि. [अ.मू. हिरिक्+क] --- १. कुनै प्रिय वस्तु वा व्यक्तिको प्राप्तिका निम्ति हत्ते हाल्ने गरी; प्रेममा नराम्रोसँग फस्ने चालले। २. प्राण जाने गरी; मर्ने चालले।
हिरिक्किनु --- अ.क्रि. --- कुनै वस्तुको प्राप्तिका लागि तीव्र इच्छा गर्नु; हिरिक्क हुनु।
हिरिक्क्याइ- --- ना. --- हिरिक्किने भाव, क्रिया वा प्रक्रिया।
हिरिक्क्याहट --- ना. --- हिरिक्क हुने भाव, अवस्था वा क्रियाप्रक्रिया।
हिर्काइ- --- ना. [√ हिर्काउ (+आइ)] --- हिर्काउने भाव, क्रिया वा प्रक्रिया।
हिर्काइनु- --- क.क्रि. --- हिर्काउने काम गरिनु; हानिनु।
हिर्काउनु- --- स.क्रि. --- मर्मान्तक पीडा हुने गरी पिट्नु, हान्नु।
हिर्किनु- --- स.क्रि. --- वेगले कतै जानु (निन्दार्थमा)।
हिर्दोक- --- वि. --- अँगाल्न पनि नहुने अफाल्न पनि नसकिने; नलिनु नछोड्नु खालको; गर्नु न मर्नु भएको।
हिलमिल --- ना. --- राम्रो मेलमिलाप, हृदयदेखिको मेल; हिमचिम।
हिलिनु --- अ.क्रि. [हिलो इ+नु] --- हिलो हुनु, माटो, बालुवा आदिमा पानी मिसिई लेदो हुनु।
हिलिनु- --- अ.क्रि. [सं. हेष+इ+नु] --- १. बेफ्वाँकमा गिजिएर हाँस्नु। २. घोडा कराउनु; हिनहिनाउनु।
हिलिलिलि- --- क्रि.वि. [हिल्ल+ ई (द्वि.)] --- १. घोडा कराउने गरी; हिनहिनाउने चालले। २. गिजिएर हाँसिरहने गरी; हिलिने चालले।
हिलीमिली- --- ना. [√ हेलमेल] --- हृदयदेखिको मेलमिलाप; हेलमेल; हिमचिम; हिलमिल।
हिले- --- वि. [हिलो+ए] --- १. हिलोमा हुने वा पाइने; हिलाको; हिलोसम्बन्धी। ना. २. रोपाइँ गर्दा परस्परमा हिलो छ्यापाछ्‌याप गरेर खेलिने खेल।
हिले जात्रा- --- ना. --- गाईजात्राको भोलिपल्ट रोपाइँको अभिनय गरेर देखाइने जात्रा; रोपाइँजात्रा।
हिले पालुङ्गो- --- ना. --- पालुङ्गोभन्दा लामा पहेंल्छ्या पात र फुस्रो डाँठ हुने पालुङ्गो; गोब्रे पालुङ्गो।
हिले फागु- --- ना. --- अबिरको सट्टा हिलो घस्नेछ्याप्ने गरेर खेलिने खेल वा त्यस्तो फागुजात्रा।
हिले माछो --- ना. --- हिलामा वा मैलो पानीमा बस्ने माछो।
हिलो- --- ना. [प्रा. हिल] --- पानीमा मुछिएको माटो; माटाको लेदो; पङ्क।
हिल्याइ- --- ना. [√ हिल्याउ (+आइ)] --- हिल्याउने भाव, क्रिया वा प्रक्रिया।
हिल्याइनु- --- क.क्रि. --- हिल्याउने काम गरिनु, हिलो पारिनु।
हिल्याउनु- --- स.क्रि. [हिलो+याउ+नु] --- रोपाइँ गर्दा खेतको माटोमा पानी लगाई जोती वा खनी हिलो पार्नु; बाउसे गर्नु; टाकुचे गर्नु।
हिल्ल- --- क्रि.वि. [अ.मू. हिल्+ल] --- १. गिजिएर हाँस्ने गरी। २. खित्का छाडेर हाँस्ने किसिमले।
हिल्ला- --- ना. [अ. हील] --- कुनै वस्तु, व्यक्ति वा आफूले गर्नुपर्ने कामकुरो आफू पन्सने गरी अरूलाई सुम्पिने काम; जिम्मा।
हिसाब- --- ना. [अ.] --- १. वस्तुहरूको सङ्ख्या वा परिमाण तोक्ने काम; गणना; गन्ती। २. आम्दानीखर्चको लेखाजोखा; हरहिसाब। ३. गणितशास्त्र; गणितविद्या। ४. भाउ; दर। ५. नियम; अनुशासन; रीति। ६. ढङ्ग; चाल; तरिका। ७. पर्वाह; वास्ता।
हिसाबकिताब- --- ना. --- १. आम्दानीखर्चको लेखाजोखा; लेनदेन-व्यवहारको निर्धारण; हरहिसाब। २. हिसाब लेख्ने किताब। ३. लेनदेनसम्बन्धी व्यवहार। ४. सुहाउँदो व्यवस्था; बन्दोबस्त।
हिसाब जाँच- --- ना. --- आम्दानीखर्चको लेखाजोखा हेर्ने काम।
हिसाब सान्ती- --- ना. --- हिसाब वा अनुपातअनुसारको भाग बाँडिलिने काम।
हिसाबी- --- वि. --- १. हिसाब गर्ने; गन्ती गर्ने। २. हिसाब जान्ने; गणितज्ञ। ३. अरूको तिर्नुपर्ने पैसाबारे वास्ता नराखी लिनुपर्ने पैसाको पछि लाग्ने।
हिसी- --- ना. [नेवा.? सं. श्री] --- १. सौन्दर्य, लावण्य। २. छाँटकाँट मिलेर राम्रो बनेको रूप।
हिस्स- --- क्रि.वि. [√ हस्स] --- १. चाहना गरेको वस्तु नपाउँदा निराश हुने गरी; हिस्सिने चालले; जिल्ल; खिस्रिक्क; ङिच्च । (उदा. हिस्स बुढी खिस्स दाँत। - उखान)। २. मुसुक्क; खिस्स।
हिस्सा- --- ना. [अ. हिस्स] --- १. बाँडफाँड गर्दा हुने कसैको अधिकार भएको वस्तु वा वस्तुको एकाइ; भाग; अंश। २. मूल समूहको कुनै एकाइ; खण्ड; टुक्रो। ३. चकला।
हिस्सादार- --- वि. --- भागबन्डाको हकदार; हिस्सेदार।
हिस्सा विभाजन- --- ना. --- अंशभाग गर्ने काम; बाँडफाँड।
हिस्सिनु- --- अ.क्रि. [हिस्स+इ+नु] --- १. चाहेको वस्तु नपाएर निराश हुनु; हिस्स पर्नु; जिल्लिनु। २. खिसिक्क हुनु; ङिच्च पर्नु।
हिस्सी- --- ना. [√ हिसी] --- हिसी; सौन्दर्य।
हिस्सी परेको --- वि. --- छाँटकाँट मिलेको; ज्यादै सुन्दर (अनुहार, रूप आदि)।
हिस्सेदार- --- वि. [हिस्सा+दार] --- १. कुनै किसिमको सम्पत्ति वा व्यवसायमा हिस्सा भएको; भागबन्डाको हकदार; अंसियार। ना. २. त्यस्तो हिस्सा वा हक भएको व्यक्ति।
हिस्सेदारी- --- ना. --- १. हिस्सेदारको हक; हिस्सा; भाग; अंश। २. साझा; गोस्वारा।
हिस्स्याइ- --- ना. [√ हिस्सि (+याइ)] --- १. हिस्सिने भाव, क्रिया वा प्रक्रिया। [हिस्स्याउ+आइ] २. हिस्स्याउने भाव, क्रिया वा प्रक्रिया।
हिस्स्याइनु- --- क.क्रि. --- हिस्स पारिनु; जिल्ल्याइनु।
हिस्स्याउनु- --- स.क्रि. [हिस्सी+याउ+नु] --- १. चाहनाको वस्तु नदिएर वा अवरोध खडा गरेर निराश पार्नु; हिस्स पार्नु। २. खिसिक्क तुल्याउनु; ङिच्च पार्नु।
हीँ- --- वि.बो. --- १. लाचारी वा लज्जाको भाव व्यक्त गर्दा मुखबाट निस्कने शब्द। क्रि.वि. २. कमजोरी व्यक्त गर्ने चालले; दीनतापूर्वक रुने गरी। ३. हार स्वीकार गरेर लजाउँदै।
हीँहीँ- --- ना. --- १. लाचारी प्रकट गर्ने वा अनकनाएको भाव जनाउने शब्द; हैं-हैं। क्रि.वि. २. केटाकेटी रुँदा निस्कने शब्द जसरी। ३. विनम्र भएर खुसामद गर्दा प्रयोग गरिने शब्द हैं।
हीन- --- वि [सं.] --- १. अधम; क्षुद्र; नीच। २. कम; घटी। ३. निन्दा गर्न योग्य; गर्हणीय। ४. गरिब, दीन। ५. पद, मार्ग, स्थान आदिबाट च्युत; भ्रष्ट। ६. नाम पदका पछि गाँसिएर नभएको, रहित, तुच्छ आदि अर्थ बुझाउने शब्द (जस्तो- पुत्रहीन, भाग्यहीन, मतिहीन आदि)।
हीनता- --- ना. --- हीन हुनाको भाव, गुण वा अवस्था; कमी; न्यूनता।
हीनताग्रन्थि --- ना. --- आफूलाई हीन वा कमजोर सम्झने मनोरोग; हीनताबोध ।
हीनताबोध --- ना. --- आफूलाई हीन सम्झने वा आफू सानो हुँ भन्ठान्ने मानसिक भावना; हीन भावनाको बोध; हीनताग्रन्थि।
हीनताभास- --- ना. --- हीनताको प्रतीति; हीनत्वबोध।
हीनत्व- --- ना. [सं.] --- आफूलाई हीन वा कमजोर मान्ने प्रवृत्ति; हीनता।
हीनबुद्धि/हीनमति- --- वि. [सं.] --- बुद्धि नभएको; मतिहीन; मूर्ख।
हीनयान- --- ना. [सं.] --- कर्मकाण्डपद्धति नमान्ने बौद्धधर्मीहरूको एक सम्प्रदाय; बौद्ध सम्प्रदायका हीनयान, महायान र वज्रयान तीन सम्प्रदायमध्ये एक।
हीरक- --- ना. [सं.] --- हीरा।
हीरक जयन्ती- --- ना --- कुनै विशेष व्यक्ति, संस्था, कार्य आदिको जन्म भएको साठी वर्षमा प्रवेश हुँदा मनाइने विशेष उत्सव।
हीरा- --- ना. --- हे. हिरा।
हीही- --- ना. [अ.मू. ही (द्वि.)] --- १. घोडा कराएको आबाज; हिनहिनाहट। २. हल्का हाँसोमा सुनिने शब्द।
हुँ- --- वि.बो. [सं. हुम्] --- कसैलाई तर्साउन वा हप्काउन बोलिने शब्द; हाँ।
हुँगिया- --- ना. --- दन्त्यकथामा हुँगियासँग लोली मिलाउन प्रयोग गरिएको एक कल्पित रुख।
हँडल्नु --- स.क्रि. [सं. हिल्लोल+नु] --- १. तरल वा लेदो पदार्थ एक जिउ हुने गरी चलाउनु, घोल्नु। २. रोटी पकाउन पानी मिसिएको पिठोफेट्नु; फाउनु। ३. हँडलो मच्चाउनु, झगडा उठाउनु; राडो मच्चाउनु।
हुँडलहाँडल --- ना. --- कुनै वस्तु हुँडल्ने र चलाउने काम; तलमाथि र वरपर पार्ने काम।
हुँडलाइ- --- ना. --- हँडल्ने भाव, क्रिया वा प्रक्रिया।
हुँडलिनु --- अ.क्रि. --- १. तरल वा लेदो पदार्थ चल्नु; घोलिनु। २. मिसिनु। क.क्रि. ३. हँडल्ने काम गरिनु; फेटिनु।
हुँडलो --- ना. --- धेरै जनाका बिचको मनोमालिन्य; राडो; रडाको; खिचलो।
हुँडल्याइ- --- ना. --- हुँडलिने भाव, क्रिया वा प्रक्रिया।
हुँडार- --- ना. [हुण्ड] --- ब्वाँसो।
```
-------------------
