-------------------
```
सो --- सर्व. [सं. सः] --- १. पहिले उल्लेख भइसकेका वस्तुका नामको सट्टामा प्रयोग हुने सर्वनाम; त्यो। वि. २. उक्त; त्यही; निज। (उदा.- सो कुरो मैले बुझिनँ)।
सौंठो- --- ना. [सं. सोट्ट] --- १. मोटो लट्ठी; ठुलो घोचो; लाठो। २. लाठाको प्रहार; लट्ठीको हनाइ।
साँस- --- ना. [सं. शिशुमार] --- कालो वा खैरो रङको पिठिउँ, सेतो रङको छाती र लामो थुतुनु हुने एक जातको स्तनपायी जलचर; गुंज (डल्फिन माछो)।
सोइपरी- --- क्रि.वि. [सो+पर्+ई] --- त्यसमा पनि; अझ; झन् अझ। (उदा.- ऊ मकहाँ आफैँ आउनुपर्ने थियो, सोइपरी मैले त डाकेकै हुँ )
सोइला/सोइलो- --- ना. [सं. शलाका] --- १. गाडी वा हलामा लगाइने, गोरु वा राँगाका जुवामा ठोकिने काठको छोटाछोटा डन्डी; जुवामा गोरु वा राँगाको गर्दनलाई यताउति सर्न नदिन जडिएको सोही साधन। २. काठको तिखो, लामो कुनै पनि ठेडी वा सुइरो।
सोकाउनु- --- अ.क्रि. [सोक+आउ+नु] --- शोकमा पर्नु; शोकग्रस्त हुनु; सोगाउनु ।
सोकेस- --- ना. [अड्.] --- कुनै वस्तुहरू प्रदर्शन गर्दा वा बेच्दा सुरक्षित राख्न सिसा ठोकेर बनाइएको दराज, प्रदर्शनी वा बिक्रीका नमुना सुरक्षित रूपमा राख्न बनाइएको पारदर्शक वस्तु जडिएको दराज वा कुनै पनि वास्तुशिल्प।
सोक्पा- --- ना. [भो.ब.] --- हिमालयका गुफातिर बस्ने र जङ्गली मान्छे भनी प्रसिद्ध एक पुराकथात्मक वा दन्त्यकथात्मक प्राणी; हिममानव; यती; याँठे।
सोक्याहा- --- वि. [शोक याहा] --- जतिखेर पनि शोकै मात्र गरिरहने; शोक गर्ने स्वभावको; चिन्तालु; सुर्तालु।
सोख- --- ना. [अ. शौक] --- १. आफूलाई मन परेको वस्तुको सङ्ग्रह, उपभोग आदि गर्ने प्रबल चाहना; इच्छा। २. सुख; ऐसआराम; आनन्द; अयस।
सोखिन- --- वि. --- सोखी (कलाकार, खेलाडी, शिल्पी आदि); सौखिन।
सोखिलो --- वि. --- सोख गर्ने स्वभाव भएको; सोखी; आमोदप्रेमी।
सोखी- --- वि. --- १. कुनै विषयमा चिन्ता नगर्ने। २. कुनै व्यवसाय, शिल्प, कला वा क्रीडामा पेट पाल्ने उद्देश्यले नलागी केवल मन बहलाउने उद्देश्यले लागेको; सौखिन ।
सोख्ता- --- ना. [फा. सोख्त] --- मसी आदि सोस्ने काममा प्रयोग हुने खस्रो किसिमको बाक्लो कागत; सोस्ता (ब्लटिङ पेपर)।
सोगाउनु- --- अ.क्रि. --- हे. सोकाउनु।
सोघा- --- ना. [लिम्बू.] --- लिम्बू संस्कृतिमा मान्छेलाई अकाल मृत्युको सिकार बनाउँछ भनी विश्वास गरिने एक प्रेत।
सोच्नु- --- स.क्रि. [सं. शोचन] --- १. विचारमा डुबेर चिन्तन गर्नु; मनन गर्नु। २. शोकसुर्ता गर्नु; अपशोच गर्नु।
सोच- --- ना. --- १. कुनै विषयमा विचारमग्न हुने काम; मनन; सोच्ने काम। २. सङ्ग्रह; जोरजाम; सञ्चय; साँच। ३. मनमा पर्ने चिन्ता; मनको पिर।
सोचना- --- ना. --- १. चिन्तन गर्ने काम; विचार गराइ । २. चिन्तन; सोचविचार गरेर मात्रै गरिने कुनै निर्णय। ३. विवेक दृष्टि; बुद्धिको सदुपयोग। ४. सोचाइ वा विचार गराइ।
सोचाइ- --- ना. --- सोच्ने भाव, क्रिया वा प्रक्रिया।
सोचाइनु- --- क.क्रि. --- सोच्न लाइनु।
सोचाउनु- --- प्रे.क्रि. --- सोच्ने गराउनु; विचार गराउनु।
सोचिनु- --- क.क्रि. --- सोच्ने काम गरिनु; विचार गरिनु।
सोज- --- ना. [सं. शोच/सुझ] --- १. सोचविचार गर्ने काम; सोझ। २. कुनै वस्तु जोरजाम गरेर जोगार गर्ने काम; जोहो; जगेडा। ३. सुझ।
सोजा- --- ना. [मोजाको अनुकरण सादृश्य] --- गोडामा मोजाभन्दा बाहिरपट्टि लगाइने जुत्ताका आकारको कपडा आदिको वस्तु।
सोझ- --- ना. --- हे. सोज।
सोझासोझी- --- ना. [सोझो सोझो] --- १. आमुन्नेसामुन्ने; आम्नेसाम्ने। क्रि.वि. २. विना छलकपट, इमानदारीसाथ; हाक्काहाक्की।
सोझिनु- --- अ.क्रि. [सोझो ई+नु] --- १. सिधा हुनु; बा‌ङ्गोको विपरीत हुनु। २. भनेको मान्ने हुनु; नबटारिनु। ३. उद्देश्यतिर उन्मुख भई अघि बढ्नु। क.क्रि. ४. सोझो पारिनु।
सोझी- --- क्रि.वि. [सोझो ई] --- १. सामुन्ने; एकदमै सीधै; सामु पारेर; सोझै । २. कतै वा कहीँ पनि नरोकिईकन; सरासर; कतै नअलमलिई।
सोझेटो- --- ना. [सोझो+टो] --- सोझो बाटो; चोर बाटो, पियालो।
सोझेरी- --- क्रि.वि. [सोझो+एरी] --- १. सिधासाधा हिसाबले; बाङ्गोटिङ्गो नगरी; सोझै । २. छलकपटविना। ना. २. सोझो मति; सोझो कार्य; सोझो वचन।
सोझै- --- क्रि.वि. --- सीधै; सरासर; सोझी।
सोझो --- वि. [प्रा. सोझ्झ] --- १. बाङ्गोको विपरीत; सिधा। २. छलकपट नगर्ने; इमानदार; सरल स्वभावको।
सोझो कुरा- --- ना. --- भएको साँचो कुरा; खसोखास।
सोझो मन- --- ना. --- शुद्ध चित्त; असल नियत।
सोझो मुख- --- ना. --- झर्कोफर्को नगरेको वा नरिसाएको मुख।
सोझो हात- --- ना. --- आफूले ताकेको ठाउँमा लाग्ने हात।
सोझ्याइ- --- ना. [√ सोझ (+याइ)] --- सोझिने क्रिया वा प्रक्रिया।
सोभ्याइनु- --- क.क्रि. --- सोझो पारिनु; सिधा बनाइनु।
सोभ्याउनु- --- प्रे.क्रि./स.क्रि. --- सोझो पार्नु; सिधा गर्नु; सोझो वा सिधा पार्न लगाउनु।
सोट्ट्ठा- --- ना. [अ.मू. स्वाँठ+आ] --- १. कसैलाई पिट्ने काममा प्रयोग गरिने लट्ठी; डन्डा; साँट्ट्ठा। २. सिर्कनु; छडी। ३. सन्ठी।
सोठिनु- --- अ.क्रि. --- डन्डाद्वारा लाग्नु; पिटाइ हुनु; कुटिनु।
सोट्ट्याइ- --- ना. --- सोट्ठ्याउने भाव, क्रिया वा प्रक्रिया।
सोट्ट्याइनु- --- क.क्रि. --- सोट्ठैसोट्ट्ठाले पिटिनु; गोदाइनु।
सोट्ट्याउनु- --- स.क्रि./प्रे.क्रि. --- लट्ठीले मार गोद्नु वा गोदाउनु; चुट्नु वा चुटाउनु।
सोठा- --- ना. [सौंठा] --- १. कपडा सिउने मेसिनको धागो बेर्ने कागतको टोक्रो।
सोठो- --- ना. [साँठो] --- १. मोटो लट्ठी; लामो घोचो; साँठो। २. सोठाको प्रहार।
सोडा- --- ना. [फा. शोर] --- १. लुगाफाटा, भाँडाकुँडा आदि धुने काममा प्रयोग गरिने पाउडरजस्तो धुलो क्षार पदार्थ। २. पानीमा मिलाएर वा रोटी आदि उकास्ने काममा प्रयोग गरेर खाइने वस्तु; खाने सोडा।
सोडातोडा- --- ना. [(द्वि.) सोडा+तोडा = तोडासोडा] --- चर्सासँग लगाइने रकमको नाम।
सोडापानी- --- ना. [सोडा+पानी] --- सोडा र एस्कर्बिक एसिडसमेत मिलाई बोतलमा बन्द गरिएको पानी; सोडादार पानी।
सोतर- --- ना. [सं. शोषास्तर > प्रा. सोसअत्त > सोहत्त+र] --- १. पलुवा पशुहरूलाई थलो ओबानो राख्नका निम्ति ओछ्याइने सुक्खा पातपत्कर आदि। २. बिछ्‌याइने काममा प्रयोग हुने एक जातको उन्यूँ; सोत्रे उन्यूँ। वि. ३. बिरामी भई पसारो परेको; लम्पसार परेको। ४. जथाभावी छरिएको।
सोताङ्गी- --- ना. [सोताङ्ग+ई] --- १. सोताङ वर्गका किराती जातिहरूले बोल्ने भाषाको नाम। वि. २. सोताङहरूको; सोताङसम्बन्धी।
सोताला- --- ना. [भो.ब.] --- आदरका रूपमा लोग्नेमानिसलाई प्रयोग गरिने शब्द।
सोती- --- ना. [सोतो+ई] --- १. तेर्सो परेको ठाउँमा सलल बगेर पानी जाने ठाउँ; सोतो परेको ठाउँ। २. पहाडको काखमा रहेको मसिना गरा भएको सानो खेत। ३. नेपालका बाहुनछेत्रीको एक थर। ४. घरभित्रको एक कोठाबाट अर्को कोठामा जाने वा भित्रबाहिर गर्ने छेडो (कोराइडर)।
सोते- --- ना. [सोतो+ए] --- १. बाँस काटेर बनाइएको (चिलिम जड्न हुने) हुक्का। २. बाँसको हुक्का। वि. ३. सोतो परेको।
सोतो- --- ना. [सं. स्रोत] --- १. सोझो, साँघुरो र लाम्चो परेको बाटो वा ठाउँ। २. सुलुत्त परेको वस्तु। ३. बादल, धुवाँ, ज्योति आदिको मुस्लो। ४. पानीको मुल्को; जलप्रवाह; स्रोत। ५. ससानो कुलो।
सोत्रिनु- --- अ.क्रि. [सोतर+इ+नु] --- १. सोतर मैं जथाभाबी छरिनु; बग्रेलो हुनु। २. धराशयी भएर सामूहिक रूपमा ढल्नु।
सोत्रे- --- ना. --- १. रुघामर्कीको रोग। २. मौरीका भन्दा केही साना बोट र अलि फुस्रा पात हुने एक वृक्ष।
सोत्रे उन्यु- --- ना. --- सोतर बनाउने काममा प्रयोग हुने एक जातको उन्यु; उन्यूँको एक भेद।
सोत्र्यान- --- ना. --- १. सोतर मैं जतासुकै छरिने काम; असरल्ल भई लम्पसार पर्ने काम। २. सोतर बनेका वस्तुहरूको समूह।
सोत्र्याम्म- --- क्रि.वि. --- १. जथाभावी सुत्ने वा गन्द्र्याङ्ग लड्ने गरी। वि. २. सोत्तर परेको; सोत्रिएको।
सोदर- --- वि. [सं.] --- एउटै गर्भबाट जन्मेको; आफ्नै आमाका गर्भबाट जन्मेको; सहोदर।
सोदरा- --- वि. --- एकै गर्भबाट जन्मिएकी; सहोदरा।
सोदरीय- --- वि. --- एकै गर्भको; सहोदर।
सोदाहरण- --- वि. [सं.] --- उदाहरणसहितको; प्रस्ट पार्नका निम्ति उदाहरणसमेत दिइएको। क्रि.वि. २. उदाहरणका साथमा।
सोद्देश्य- --- वि. [सं.] --- १. उद्देश्यसहितको; उद्देश्यले युक्त भएको; उद्देश्य राखिएको। क्रि.वि. २. उद्देश्यका साथमा।
सोध्नु- --- स.क्रि. [सं. शोधन+नु] --- १. कसैलाई कुनै कुराको प्रश्न गर्नु। २. जवाफ माग्नु; निधो माग्नु। ३. शुद्ध गर्नु; संशोधन गर्नु। ४. खारखेर गर्नु; बयान लिनु । ५. औषधीहरू परिशोधन गर्नु; दबाई बनाउनु ।
सोध- --- ना. [सं. शोध] --- लिएको रकम फिर्ता गर्ने काम; सट्टाभर्ना।
सोधनी- --- ना. [सोध्+अनी] --- सोध्ने काम; सोधाइ; प्रश्न; सबाल।
सोधपुछ- --- ना. [सोध् + हि. पुछ] --- प्रश्नगराइ; केरकार।
सोधभर्ना --- ना. [सोध्+भर्ना] --- पहिले लिएको रकम वा जिन्सी आदि पछि भर्ना गर्ने काम; लिएको बढी रकम, तलब, भत्ता आदिबाट कट्टा गरी हिसाब मिलाउने काम; सट्टाभर्ना।
सोधाइ- --- ना. [√ सोध् (+आइ)] --- सोध्ने भाव, क्रिया वा प्रक्रिया।
सोधाइनु- --- क.क्रि. --- सोध्ने काम गराइनु; सोध्न लाइनु।
सोधाउनु- --- प्रे.क्रि. --- सोध्ने काम गराउनु; सोध्न लगाउनु।
सोधिनु- --- क.क्रि. --- सोध्ने काम गरिनु।
सोपाधि- --- वि. [सं.] --- उपाधि वा दर्जासहितको उपाधि।
सोपाधिक- --- वि. --- उपाधिले सहित वा युक्त भएको; उपाधिसहितको।
सोपान- --- ना. [सं.] --- भऱ्याङ; लिस्नो।
सोप्याक्क- --- क्रि.वि. [अ.मू. सोप्याक्+क] --- हे. सुप्रुक्क।
सोफा- --- ना. [अङ्.] --- कपास, फोम आदिका साथै स्प्रिङसमेत जडी बाहिरबाट कपडा आदिको आवरण हाली तयार पारिएको अडेसदार लामो बेन्च।
सोफा सेट- --- ना. --- सोफा र आवश्यक अन्य वस्तुको बाना (कुर्सी, टेबुल इ.)।
सोभान- --- ना. [सं. सुवाणी] --- राम्रो आनीबानी; सुबान।
सोभान साही- --- ना. --- एकीकरणपूर्वको जुम्ला राज्यका अन्तिम कल्यालवंशी राजा।
सोभिता- --- ना. [सं.] --- रछाया रङको, एक प्रकारको निकेलजस्तो धातु।
सोम- --- वि. --- १. धेरै समयसम्म सुतिरहने; सुताहा। २. अल्सी; लोसो। ३. बितेबिग्रेको वास्तै नगर्ने; कुनै कुराको पर्बाह नभएको। ४. कृपण; किरन्टोकी।
सोम- --- ना. [सं.] --- १. जून; चन्द्रमा। २. आइतबारका भोलिपल्टको बार; सौंबार । ३. देवताहरूले पान गर्ने अमृत; सोमरस। ४. सोमलता।
सोमत- --- ना. [अ. सोहबत] --- १. राम्रो किसिमको आनीबानी। २. सभ्य आचरण; सभ्यपन; सदरियापन। ३. शिष्टता; भद्रता।
सोमतिलो --- वि. --- राम्रो स्वभाव र आचरण भएको; सोमती।
सोमती- --- वि. --- राम्रो सोमत भएको।
सोमतीर्थ- --- ना. [सं.] --- भारतको काठियाबाड प्रदेशमा रहेको एक प्राचीन तीर्थस्थल; प्रभासतीर्थ।
सोमनाथ- --- ना. [सं.] --- सोमतीर्थमा रहेका मन्दिरमा रहेको शिवको मूर्ति; बाह्रवटा ज्योतिर्लिङ्गमध्ये प्रसिद्ध एक लिङ्ङ्ग।
सोदाहरण- --- वि. [सं.] --- उदाहरणसहितको; प्रस्ट पार्नका निम्ति उदाहरणसमेत दिइएको। क्रि.वि. २. उदाहरणका साथमा।
सोमपान- --- ना. [सं.] --- १. सोमलताको रसपान गर्ने काम; सोमरसको पान। २. मदिरापान गर्ने काम।
सो --- झुन्डिएर वा बसेर हल्लिँदै खेलिने खेल; बालक्रीडाको एक प्रकार; चच है।
```
-------------------
