-------------------
```
टट्कारो/टट्कालो- --- वि. [टाठो+कारो] --- स्पष्ट देखिने; खुलस्त; सफा; तड्कारो ।
टट्टरी- --- ना. [सं.] --- १. ठट्टा; दिल्लगी। २. नभएको कुरा; झुटो व्यवहार। ३. एक प्रकारको ढोलबाजा।
टट्टाइ- --- ना. [√ टट्टाउ (+आइ)] --- टट्टाउने भाव, क्रिया वा प्रक्रिया।
टट्टाइनु- --- अ.क्रि. --- टट्टाइ अनुभव गर्ने होइनु।
टट्टाइलो/टट्टाउँदो --- वि. --- टट्टाउने खालको।
टट्टाउनु- --- अ.क्रि. [सं. टण्ट+आउ+नु] --- १. शरीरमा चोटपटक लागेको वा घाउखटिरा भएको ठाउँमा कडा वस्तु वा चहऱ्याउने औषधी पर्दा चर्को किसिमले दुख्नु; चहऱ्याउनु; भबाउनु। २. भोक, प्यास, गर्मी आदिले सताउनु, पीडा हुनु।
टट्टिनु- --- अ.क्रि. --- १. दिनभर भोकै पर्नु, भोक, प्यास, गर्मी आदिले पीडित हुनु। २. अप्ठेरो ठाउँमा बस्दा बस्दा उराठ लाग्नु। ३. टाट पल्टनु। ४. दुब्लाउनु।
टट्टी- --- ना. [सं. तटी] --- १. बाँस, नर्कटका चिर्पट आदिले बनाइएको पर्दा; बार; फरिको; टाटी। २. पाइखाना; चर्पी। ३. मान्छेको मल; दिसा।
टट्टी/टट्टु- --- वि. [टाट+ई/ऊ] --- हाडछाला मात्र बाँकी भएको; ज्यादै दुब्लो; हल्लनटाट।
टट्ट्याइ- --- ना. [√ टट्टि (+याइ)] --- हे. टट्टाइ।
टट्ट्याइनु- --- अ.क्रि. --- टट्टाइनु।
टट्ट्याउनु- --- अ.क्रि. --- टट्टाउनु।
टठ- --- ना. [सं. धृष्ट] --- १. गर्व; सेखी; अभिमान; घमन्ड। २. झगडा; निहुँ।
टठमराइ- --- ना. [√ टठमराउ (+आइ)] --- टठमराउने क्रिया वा प्रक्रिया।
टठमराइनु- --- अ.क्रि. --- टाठो वा अग्रसर होइनु।
टठमराइलो --- वि. --- १. टाठो। २. तत्पर।
टठमराउनु- --- अ.क्रि. [टाठो+बाठो+आउनु> टठबडाउनु] --- १. परिआएको काममा अगाडि सर्नु; टाठोबाठो हुनु। २. तरखराउनु, तयार हुनु।
टठिलो --- वि. [टाठो+इलो] --- १. टाठो भएको; चड्ङ्ख। २. जाँगरिलो; कामगरैया। ३. मोटोघाटो; हृष्टपुष्ट; खाएपिएको। ३. चलाक; बाठो; चतुरो; चड्ङ्ख।
टठी- --- वि. [टठ+ई] --- टठ गर्ने; घमन्डी; सेखीवाल; अभिमानी।
टठ्याइँ- --- ना. [टाठो+याइँ] --- टाठो हुनाको भाव वा अवस्था; बठ्याइँ।
टड्कारो/टकालो- --- वि. [√ टट्कारो] --- प्रस्ट; स्पष्ट; तड्कालो; टट्कालो।
टन- --- वि. [अ.] --- झन्डै अट्ठाइस मनको तौल; पच्चिस मेट्रिक टनको तौल।
टन- --- वि. [अ.मू. टन्+अ] --- १. लागु पदार्थको सेवनले लट्ठ परेको; नशाले लठ्ठिएको; रक्सी धोकेको; टुन्न। २. भरिएको; धन, सम्पत्तिले पूर्ण; टन्न। ३. मोटाएको। ४. अघाएको। ५. कस्सिएको; टनक्क; टुनुक्क।
टनक- --- ना. --- घाउको पीडा; टन्को; जलन।
टनकटनक- --- क्रि.वि. --- शरीरको कुनै भागमा रोग लागेर दुखिरहने गरी; घाउखटिरामा पानी वा पिप भरिएर अथवा अरू कुनै कारणले दुख्ने किसिमले; टनक्क टनक्क; टनटन।
टनक्क- --- क्रि.वि. --- १. शरीरको कुनै अवयवमा रोग लागेर दुख्ने गरी; घाउखटिरामा पानी वा पिप भरिएर दुख्ने गरी। २. वायुविकारले शरीरको स्नायु व्यवस्थामा बाधा परी पीडा हुने किसिमले ३. डोरीले बेसरी कस्ने किसिमसित। वि. ४. कसिएको। ५. पीडाजनक वा ज्वलनशील।
टनटन- --- ना. [टन्टा] --- नचाहिँदो किसिमको कचकच; बिनसित्तिको कचकच; रडाको; टन्टा; लेठो।
टनटन- --- क्रि.वि. [ने.] --- १. घाउखटिराहरू टन्कने गरी; टनकटनक। २. फुर्ती झिकेर हिँड्ने चालले; लमकझमक। ३. टन्न कसेर बाँध्ने चालमा; टनक्क। ४. घण्टा आदि लगातार बज्ने गरी।
टनटनती/टनटनी- --- क्रि.वि. --- टनक्क हुने (दुख्ने, लम्कने, बज्ने, भरिने, कसिने) गरी।
टनटने- --- ना. [सं. स्थाणु > ठानु (द्वि.)+ए] --- हरियो चिल्लो डाँठ र बाँसका जस्ता आँख्ला हुने, हाँगापात नहुने, कुरकुरे जस्तै सुलुत्त परेको झार।
टनाटन- --- क्रि.वि. [अ.मू. टन+आ+टन] --- १. भाँडोमा कुनै वस्तु खाँदिएर चुलिने गरी; अटाई नअटाई; टमाटम; भरिभराउ। वि. २. पुरै भरिएको; टन्न।
टनेल- --- ना. [अड्] --- १. पहाडको भित्रभित्रै बनाइएको बाटो वा कुलो। २. सुरुङ।
टन्कनु --- अ.क्रि. --- १. घाउखटिरा पिलिएर रन्थनिनु; पीडा हुनु; बल्कनु; भबाउनु। २. ज्यादै कसिने गरी वा नफुत्कने किसिमले बाँधिनु बेसरी तानिनु।
टन्काइ- --- ना. --- १. घाउ आदिको दुखाइ। २. डोरी वा दाम्लाको कसाइ।
टन्काइनु- --- क.क्रि. --- टन्कने पारिनु; बेसरी दुखाइनु वा कसिनु।
टन्काउनु- --- प्रे.क्रि./स.क्रि. --- टन्कने पार्नु; बेसरी दुखाउनु वा कस्नु।
टन्किनु --- अ.क्रि. --- १. टन्कनु। २. चर्कोसँग दुख्नु, भबाउनु। ३. कसिने गरी बाँधिनु।
टन्को --- ना. --- १. घाउखटिरा आदिको दुखाइ, रनक। २. डोरी आदिको कसाइ; टन्काइ।
टन्टकपाले- --- वि. --- नचाहिँदो झन्झट बोकेर हिँड्ने; अनावश्यक झमेला बेसाउने; टन्टा बोकेर काम गर्ने; अनावश्यक रूपमा अर्काको दुखेसो आफ्नो टाउकामा लिएर हिँड्ने।
टन्टलापुर- --- वि. --- खुब पोल्ने; ज्यादा चर्को; प्रचण्ड (घाम)।
टन्टा- --- ना. --- १. नचाहिँदो झमेला; झोज; झन्झट । २. अनावश्यक कामको बोझ ।
टन्टासन्टा- --- ना. --- नचाहिँदो झोजझमेला।
टन्न- --- क्रि.वि. [अ.मू. टन्+न] --- १. भाँडामा कुनै वस्तु खाँदिएर चुलिने गरी; भरिभराउ; टनाटन। २. पूरा अघाउने गरी; गलगिज्ज। ३. घण्टा, घडी आदिमा ठक्कर लागेर बजे जस्तै गरी। ४. रक्सी आदि लागु पदार्थले लठ्ठिने गरी; लट्ठ।
टप्नु- --- स.क्रि. [टप+नु] --- १. पढाइ, उद्योग, व्यवसाय र यात्रा आदिमा अरूलाई उछिनेर अगाडि पुग्नु; पछि भएको व्यक्तिले आफूभन्दा अघिको व्यक्तिलाई भेट्टाउनु वा जित्नु। २. फड्कनु; नाघ्नु। ३. टाप ठोक्नु; भाग्नु।
टप- --- ना. [अड्.] --- कानका लोतीमा लगाइने, सानो ढुङ्ग्री जस्तै एक प्रकारको प्रायः सुनको गहना।
टप२- --- ना. [अड्.] --- बग्गी, तामदान आदिको बसाउन, उठाउन र ढाल्नसमेत मिल्ने माथिल्लो भाग वा छानु।
टप- --- ना. [अङ् ट्याप] --- साइकल, मोटरसाइकल, बग्गी; मोटर आदिको पाङ्ग्रामाथि जडिने ढकनीजस्तो कुप्रो परेको पाता।
टपक्क- --- क्रि.वि. [अ.मू. टप् > टपक्+क] --- १. एक्कासि वा सजिलै टिपेर, झट्ट टिप्ने गरी; झटपट टप्काएर। २. कसैसँग एकदम टाँसिने वा लेसिने चालमा। ३. थोपाका रूपमा झरेर; तप्प।
टपटप- --- क्रि.वि. [अ.मू. टप्+अ (द्वि.)] --- १. एक एक थोपा गरी चुहिएर; तपतप। २. कत्ति नसुस्ताई लगातार टिपेर; टपाटप। ना. ३. त्यसरी चुहिँदाको ध्वनि।
टपटपी/टपटप्ती- --- क्रि.वि. --- टपटप, टपाटप।
टपरी/टपरो- --- ना. [पतरी] --- १. बाँसको सिन्काले गाँसेर बिट उठाई बनाइएको, साल आदिका पातको थाल जस्तो भाँडो; पत्तल; ठहर।
टपरे- --- वि. --- टपरी सँगेट्ने वा सह्यार्ने; घरघरमा पुरोहित्याइँ गरी जीविका गर्ने; टपरीमा हालेका सिधाबाट गुजारा गर्ने।
टपर्तुय्याँ- --- वि. [टपरी + अ.मू. टुइँय्य+आ] --- १. अध्ययन, ज्ञान आदि नभए पनि बाहिरी बठ्याइँद्वारा आफ्नो पाण्डित्यको प्रदर्शन गर्ने; भित्री ज्ञान नभएको तर बाहिर प्रभुत्व जमाउन चाहने; लालबुझक्कड। ना. २. त्यस्तो व्यक्ति।
टपाइ- --- ना. [√ टप् (+आइ)] --- टप्ने भाव, क्रिया वा प्रक्रिया।
टपाइनु- --- क.क्रि. --- टप्न वा उछिन्न लाइनु, टप्न सक्ने बनाइनु; टप्ने पारिनु ।
टपाउनु- --- प्रे.क्रि. --- टप्ने वा उछिन्न सक्ने पार्नु; उछिन्न लाउनु; टप्न लाउनु।
टपाटप- --- क्रि.वि. [टप्+टप्.] --- जमिनबाट कुनै वस्तु वा रुखबाट फल आदि टिप्ने किसिमले; टपटपती।
टपिनु- --- क.क्रि. [टप्+इ+नु] --- १. अरूलाई उछिनेर अगाडि बढिनु वा पुगिनु। २. टप्ने वा उछिन्ने काम गरिनु।
टप्कनु- --- अ.क्रि. [अ.मू. तप्+कनु] --- १. थोपाथोपा गर्दै पानी चुहिनु वा खस्नु; बुँदबुँद गरी झर्नु। २. एक्कासि आइपुग्नु; प्रकट हुनु। स.क्रि. ३. उछिन्नु; टप्नु। ४. फड्केर नाघ्नु। ५. टपक्क टिपेर लग्ने काम हुनु।
टप्काइ- --- ना. --- टप्कने वा टप्काउने क्रियाप्रक्रिया।
टप्काइनु- --- क.क्रि. --- टपक्क टिपेर लगिनु।
टप्काउनु- --- स.क्रि./प्रे.क्रि. --- १. टपक्क टिपेर लैजानु; हात लाउनु; हातलागी गर्नु; उडाउनु। २. हरण गर्नु; चोर्नु। ३. थोपा थोपा चुहाउनु; बुँद खसाउनु।
टप्किनु- --- अ.क्रि. --- १. टप्कनु। २. थोपा थोपा गरी चुहिनु।
टप्क्याइ- --- ना. --- टप्किने भाव, क्रिया वा प्रक्रिया।
टप्प- --- क्रि.वि. [अ.मू. टप्+प] --- १. एकएक थोपा गरेझै गरी; टपक्क। २. एकै पटक मात्र केही कुरो टिप्ने किसिमले। ३. तुरुन्त टप्काउने चालमा। ४. टाँसिए जस्तै गरी। ५. एक्कासि थामिने, रोकिने वा पक्रिने चालले। ६. अकस्मात् प्रकट भएर; टुप्लुक्क।
टप्पा- --- ना. [अ. तबक] --- १. कुनै जिल्ला वा प्रगन्नाको एक हिस्सा; सानो भूभाग; इलाका; तप्पा। २. अग्लो ढिस्को; डाँडो।
टप्पा- --- ना. [सं. ताप] --- मारुनी नाचमा गाइने एक थरी राग।
टप्पु- --- ना. [टापु] --- नदीको दोभान, तलाउ वा मैदानका बिचमा उठेको जमिन वा ढिस्को; द्वीप; टाकुरो; मझौ।
टप्पू- --- वि. [टप्+पू] --- १. चङ्ख; चतुरो; २. टिप्ला वा टप्काउलाजस्तो।
टप्फा/टप्फु- --- ना. --- एक व्यक्ति र अर्को व्यक्तिको अनुहारमा देखिने अन्तर।
टफी- --- ना. [अड्] --- १. क्रिम आदि भएको चकलेट; कागजमा बन्दी गरिएको ससानो मिठाई। २. खेलमा विजेताले पाउने विजयचिह्न।
टब- --- ना. [अङ्.] --- बसेर वा पल्टेर नुहाउनका लागि पानी राख्न बनाइएको, ठुलो खुला मुख भएको सिमेन्ट आदिको भाँडो।
टमक्क- --- क्रि.वि. [अ.मू. टमक्+क] --- कपडा आदि शरीरमा टम्म मिल्ने वा कसिने गरी; सिमिक्क; टिमिक्क।
टमटम - --- ना. [अङ् ट्यान्डम] --- एउटै घोडाले तान्ने, दुई अग्ला अग्ला पाङ्ग्रा भएको हल्का बग्गी; एक्का।
टमटम - --- क्रि.वि. [अ.मू. टम्+अ (द्वि.)] --- गोडा बजार्दै फुर्तीसाथ हिँड्ने किसिमले; ठिमठिम; टिमिकटिमिक।
टमाटम- --- क्रि.वि. [अ.मू. टम्+आ+टम्] --- भाँडामा कुनै वस्तु भरिभराउ भए जस्तै गरी; टनाटन।
टमाटर- --- ना. [अङ्. टोम्याटो] --- १. आलुको जस्तो बोटबाट जमिनमाथि फल्ने आलुकै आकारको फल; गोलभेंडा; ट्यामटर। २. भन्टाको जस्तो बोटमा गोलभेंडाको स्वादको डिम्बाको आकारको फल लाग्ने एक वनस्पति। ३. त्यसै बोटमा फल्ने, गोलभेंडाको जस्तो स्वाद हुने र अचार बनाएर खाइने फल।
टमोट- --- ना. ---
टमोट- --- ना. [तामो+ओट] --- १. तामाका भाँडाकुँडा बनाउने काम; भाँडामा चढाइएको पाइन वा जलप। २. तामो कमाउने एक वर्ग; टमौटे; टुमौटे; तमोट।
टमोटे/टमौटे- --- ना. --- १. तामाको भाँडाकुँडा बनाउने व्यक्ति; ताँबोको व्यापार गर्ने व्यक्ति। २. विश्वकर्माको एक वर्ग; टमुटो।
टम्काइ- --- ना. [√ टम्काउ (+आइ)] --- टमक्क हुने क्रिया वा प्रक्रिया।
टम्काइनु- --- क.क्रि. --- टमक्क तुल्याइनु।
टम्काइलो --- वि. --- टमक्क हुने; टमक्क होलाजस्तो।
टम्काउनु- --- स.क्रि. / प्रे.क्रि. [टमक्क+आउ+नु] --- टमक्क पार्नु वा पार्न लगाउनु।
टम्के- --- ना. [सं. ताप+के] --- फलामे ठुलो भाँडो; कराही।
टम्म- --- क्रि.वि. [अ.मू. टम्+म] --- १. शरीरमा कपडा, जुत्ता आदि ठिक्क मिल्ने गरी; टमक्क। २. गुंद आदिले केही वस्तु टाँसिने गरी। ३. बाकस, ढोका आदि ठिकसँग बन्द हुने किसिमले, ढ्याम्म। ४. भाँडो सबै भरिने गरी। ५. अघाउन्जेल; टन्न। वि. ६. भरिएको;
```