-------------------
```
किर्की --- ना. --- उखु ।
किर्को --- ना. --- उखुको गिंड।
किर्कोले- --- वि. [किौँलो+ए] --- किर्कोलाजस्तो; किौँलाका ढाँचाको।
किौँलो --- ना. [किरकिर+अर्कोंलो] --- दानादार अन्नहरूका भित्र हुने सामान्य गेडाभन्दा सानो, साह्रो र नपाक्ने किसिमको दाना; चोर गेडो।
किर्यो --- ना. --- फटे‌ङ्ग्राजस्तो सानो एक प्रकारको किरो।
किर्ते --- वि. [सं. कृत्य] --- कृत्रिम; बनावटी; झुट्ठो; नक्कली; जालसाजी; कीर्ते (कागतपत्र, कामकुरो इ.)।
किर्ते साक्षी --- ना. --- झुट्ठो साक्षी; मिथ्या गवाह।
किर्नु --- ना. [किरो+नु] --- गाईबस्तुका शरीरमा लाग्ने एक प्रकारको डल्लो किरो।
किलकिञ्चित् --- ना. [सं.] --- संयोग श्रृङ्गारअन्तर्गत ज्यादै प्रिय वस्तु प्राप्त हुँदाको हर्षबाट नायिकामा उत्पन्न हुने मुस्कुराहट तथा हाँसो, रुदन, डर, क्रोध, भ्रम आदिको विचित्र मिश्रण; नायिकाले एकसाथ अनेक किसिमका भाव प्रकट गर्ने स्वाभाविक हाउभाव।
किलकिले --- ना. [सं. किलकिल] --- जिब्राको पछिल्लो भागमा झुन्डिएको कोमलतालुको सानो मांसल खण्ड; रुद्रघण्टी; लिगलिगे।
किलास --- ना. [किल्ला] --- दुई घर एकैसाथ जोडिएको गारो वा साँध; दुई घरको एक सन्धिस्थल।
किलासको गारो --- ना. --- साँधको घरसँगै जोडिएको गारो।
किलिककिलिक --- क्रि.वि. [अ. मू. किलिक्+अ (द्वि.)] --- पानी वा कुनै झोल पदार्थ उँभो घाँटी लगाई निल्ने गरी; किक्लिककिक्लिक।
किलिप --- ना. [अङ्. क्लिपा] --- १. कपाल मिलाउन, तह लाउन वा सिँगार्न स्वास्नीमानिसले शिरमा लगाउने प्लास्टिक, धातु आदिका वस्तु; चिम्टी; काँटा। २. कागजपत्र आदि च्याप्न प्रयोग गरिने एक साधन; चेपुवा।
किला --- ना. [किलोको ति. रू.] --- हे. किलो।
किला काँटा --- ना. --- जोर्ने र गाँस्ने काममा प्रयोग गरिने किला वा यस्तै अन्य सरसामान।
किले जोर्नी --- ना. [किलो+जोर्नी] --- हात, खुट्टा आदिका हड्डीहरू चलाउन हुने गरी खप्टिएको जोर्नी; किला झै गरेर जोडिएको हड्डीको जोर्नी।
किलो --- ना. [अड्] --- १. हजार सङ्ख्याको समष्टि रूप। २. एक हजार ग्राम बराबरको नापो; किलोग्राम। ३. किलोमिटरको सङ्क्षिप्त रूप।
किलोग्राम --- ना. --- एक हजार ग्राम बराबरको तौल वा राशिको एकाइ।
किलोमिटर --- ना. --- सय मिटर अर्थात् एक माइलको ५/८ भाग बराबरको नापो।
किलोवाट --- ना. --- एक हजार वाट बराबरको विद्युत्राक्तिको एकाइ।
किलो- --- ना. [सं. कील] --- १. कुर्सी, टेबुल आदि बनाउँदा काठका टुक्रालाई हतौडीले हानेर जोड्न वा भित्ता आदिमा कुनै वस्तु झुन्ड्याउन खुटीका रूपमा समेत प्रयोग गरिने, एक छेउ मोडिएको र अर्को छेउ तिखारिएको, फलाम, काठ आदिको लाम्चो काँटा। २. सुइरो। ३. जमिन, भित्ता आदिमा ठोकेर वा गाडेर बस्तुभाउ बाँधिने काठ, फलाम आदिको लाम्चो टुक्रो।
किल्ला --- ना. [अ. किला] --- १. सामरिक प्रतिरक्षाका निमित्त चारैतिरबाट घेरी सुरक्षित तुल्याइएको ठाउँ वा घर; गढी; गढ; दुर्ग; खावा; कोट। २. सिमाना; साँध।
किल्लाबन्दी --- ना. --- १. किल्ला बनाउने काम; व्यूहरचना। २. बुद्धिचालको खेलमा बादशाहलाई किस्त नलाग्ने गरी राखिने गोटी।
किल्ली --- ना. [सं. कीलक] --- १. उपाय; युक्ति। २. चलाकी; बठ्याइँ। ३. दाउपेच।
किशलय --- ना. [सं.] --- १. बोटबिरुवाबाट भर्खरै पलाएको कलिलो पात; पालुवा; पल्लव। २. कोपिला। ३. मुना; अङ्कुर।
किशोर --- ना. [सं.] --- १. पन्ध्र वर्षभन्दा कम र एघार वर्षभन्दा बढी उमेरको केटो; अवयस्क; नाबालक। २. घोडाको बच्चो; बछेडो। ३. छोरो; पुत्र। ४. बालसूर्य। वि. ५. एघार वर्षदेखि पन्ध्र वर्षभित्रको (केटो।
किशोरी --- ना. --- १. एघार वर्षदेखि पन्ध्र वर्षसम्मकी बालिका। वि. २. त्यस उमेरकी (केटी)।
किष्किन्धा --- ना. [सं.] --- दक्षिणी भारतको 'किष्किन्ध' नामक देशको राजधानी।
किसमिस --- ना. [फा. किशमिश] --- प्रायः बीज नहुने सुकेको मिठो दाख; सानो दाख।
किसान --- ना. --- खेतीपातीको काम गरेर जीविका चलाउने व्यक्ति; खेतीवाल; कृषक; कृषिजीवी; माटीकोरे।
किसानगिरी --- ना. --- किसानको काम वा पेसा; किसानी।
किसान सङ्गठन --- ना. --- किसानहरूको भलाइका निम्ति वा देशको विकासमा किसानहरूलाई संलग्न गराउने सङ्गठित संस्था।
किसानी --- ना. [किसान+ई] --- किसानको काम वा पेसा; कृषि; कोरीमाटी; किसानगिरी।
किसानी ऋण --- ना. --- कृषिसम्बन्धी औजार किन्नका निम्ति वा खेतीसम्बन्धी कामका निम्ति सम्बन्धित निकायबाट दिइने सापट।
किसिम --- ना. [अ. किस्म] --- एक थरीका वस्तु, गुण, कार्य, विचार आदिलाई अर्का थरीको तुलनामा भिन्न ठहऱ्याउने तत्त्व; प्रकार; ढाँचा; काइदा; तरिका; प्रणाली; चाला।
किसिमको --- वि. --- राम्रो; आकर्षक; काइदाको; खासा।
किस्त --- ना. [अ.] --- १. बुद्धिचाल प्रतियोगितामा विपक्षी गोटीले बादशाहलाई पारेको असुरक्षित अवस्था वा लखेटाइ। २. किस्ता।
किस्ता --- ना. [अ. किस्त] --- १. यति यति समय गुज्रिएपछि यति यति मात्रा वा अनुपातमा लिने वा दिने भनी पहिले नै निर्धारित गरिएका मात्रा वा अनुपातहरूमध्ये कुनै एक; किस्त। २. महिना भुक्तान भएपछि कर्मचारीलाई दिइने तलब, महिनावारी।
किस्ताबन्दी --- ना. --- १. किस्ता बुझाउने काम वा व्यवस्था; पटक पटक गरी तोकिएको रकम वा वस्तु बुझाउने काम। २. किस्ताको निश्चित रकम तथा समय निर्धारण गर्दाको सीमा।
किस्ता तलबी --- ना. --- पटक पटक गरेर पाइने तलबमा काम गर्ने मन्जुरी; त्यसरी काम गरेबापत पटक पटक गरेर मिल्ने तलब।
किस्ती --- ना. [फा. कश्ती] --- १. सजाइने वा उपहार दिइने चिजबिज राखिने बिटवाल, थेप्चो र चारपाटे वा गोलाकार काठ वा धातुको भाँडो। २. एक प्रकारको डुङ्गा वा नाउ। ३. सोझो मात्र चल्ने बुद्धिचालको एक गोटी।
किस्मत --- ना. [अ.] --- १. भाग्य; प्रारब्ध। २. मेहनत; परिश्रम। ३. युक्ति; चातुर्य।
किस्मती --- वि. --- १. भाग्यमानी। २. परिश्रमी; मेहनती। ३. चतुर; जुक्ति जान्ने।
किस्सा --- ना. [अ. किस्स] --- कथा वा कहानीभन्दा विस्तृत आकारको र अनेक घटनाको संयोजन हुने, मनोरञ्जनका निमित्त लेखिएको कथात्मक कृति (किस्सा तोता-मैना, किस्सा बेताल-पच्चीसी इ.)।
कीचक --- ना. [सं.] --- १. विराट राजाको सेनापति तथा सालो। २. खोक्रो बाँस; हावा जोडले चल्दा आवाज निकाल्ने बाँस । ३. एक जातिको नाम।
कीचक वध --- ना. --- १. सैरन्ध्रीको भेषमा रहेकी द्रौपदीको सतीत्व लुट्ने धृष्टता गर्दा भीमद्वारा भएको कीचकको हत्या।
कीट --- ना. --- हे. किट।
कीट --- ना. [सं.] --- किरो, कृमि।
कीटनाशक --- वि. --- किरा मार्ने वा नाश गर्ने।
कीटपतङ्ग --- ना. --- जमिनमा हिँड्ने वा उड्ने कमिलो, माकुरो, सिँगो, फट्याङ्ग्रो आदि ससाना किराको समूह; किराफट्याङ्ग्रा।
कीटविज्ञान --- ना. --- किराहरूका बारेमा शास्त्रीय ढङ्गले वर्णन तथा विवेचना गरिएको विद्या वा शास्त्र।
कीटाणु --- ना. [सं.] --- रोग उन्पन्न गर्ने सूक्ष्मदर्शी सजीव वस्तु ।
कीटाणुनाशक --- वि. --- कीटाणुहरूलाई मार्ने वा नाश गर्ने।
कीटाहारी --- ना. [सं.] --- किरा खाने एक थरी बिरुवा; पूर्णकलश।
कीमत --- ना. [अ. कीमत] --- हे. किम्मत।
कीमती --- वि. --- हे. किम्मती।
कीराफट्याङ्ग्रा --- ना. --- हे. किराफट्याङ्ग्रा।
कीरी --- ना. --- हे. किरी।
कीरो --- ना. --- हे. किरो।
कीर्ण --- वि. [सं.] --- १. छरिएको; फैलिएको; फ्याँकिएको। २. ढाकिएको; भरिएको। ३. राखिएको; रहेको। ४. चोट परेको।
कीर्तन --- ना. [सं.] --- १. अरूका गुण, यश आदिको वर्णन; गुणानुवर्णन; गुणगान। २. देवदेवताको नाम तथा यशको विशेषतः गाउँदै, बजाउँदै गरिने स्तुति; भजन; हरिकीर्तन।
कीर्तनियाँ --- वि. --- कीर्तन गर्ने; भजन गर्ने।
कीर्ति --- ना. [सं.] --- १. असल तथा ठुलो काम र बहादुरी आदिबाट प्राप्त हुने र धेरै समयसम्म टिकिरहने सुनाम वा प्रसिद्धि; ख्याति; जस; नेकनामी। २. प्रशंसा। ३. पुण्य।
कीर्तिपुर --- ना. --- काठमाडौँको दक्षिण-पश्चिमपट्टि केही अग्लो भागमा रहेको प्रसिद्ध स्थल।
कीर्तिमान्/मान --- वि. --- १. कीर्तियुक्त; प्रसिद्ध। ना. २. प्रतियोगितामा कुनै खेलाडी, उम्मेदवार आदिले स्थापित गरेको सर्वोच्च सीमा।
कीर्तिशाली --- वि. --- कीर्तिमान्।
कीर्तिशेष --- वि. --- १. कीर्ति शेष रहन गएको; मृत। ना. २. मृत्यु; मरण।
कीर्तिस्तम्भ --- ना. --- कुनै व्यक्तिको स्मरणमा उसको नामबाट खडा गरिएको स्तम्भ (भीमसेनस्तम्भ, अशोकस्तम्भ इ.)।
कीर्ते --- वि. --- हे. किर्ते।
कीर्तेसाक्षी --- ना. --- किर्तेसाक्षी।
कील --- ना. [सं.] --- १. फलाम वा काठको किलो। २. खम्बा; स्तम्भ। ३. बिग्रेर वा मरेर पाठेघरमा अड्केको गर्भ।
कीलक --- ना. [सं.] --- १. कील; किलो। २. अर्काले प्रयोग गरेको मन्त्रशक्तिलाई निष्क्रिय पार्ने मन्त्र।
कीलाक्षर --- ना. [सं.] --- सुमेर, इरान आदि देशमा आआफ्नै किसिमले प्राचीन कालमा प्रचलित बाणाकार लिपि; बाणमुख लिपि।
कीलीकरण --- ना. [सं.] --- १. पुरातत्त्वका अनुसार, उत्खनन गरिने ठाउँमा किला ठोक्ने काम। २. किला ठोक्ने क्रिया।
कीलो --- ना. --- हे. किलो।
कु१- --- कु- पू. स. [सं.] --- नामपदको अघिल्तिर जोडिएर, खराब, हास, अवमूल्यन, अनुचित, पाप, अशुभ, अभाव इ. भाव सङ्केत गर्ने उपसर्ग (कुपात्र, कुकर्म, कुदृष्टि, कुरूप, कुबेला इ.)।
कु२- --- ना. [अ. मू.] --- तालिम दिनेले बट्टाईको कानमा बेलाबखत उच्चारण गर्ने शब्द।
कु खुवाउनु --- टु. --- बट्टाईको कानमा कु शब्द उच्चारण गर्नु।
कु३- --- ना. [अङ्.] --- सैनिक विद्रोह।
कुँच --- ना. [तु. कूच] --- १. सेनाले अनुशासनपूर्वक ताल मिलाएर हिँड्ने काम; पल्टनले गर्ने मार्च; कुच। २. छिटो चालको हिँडाइ; दौडाइ। ३. भाग्ने काम।
कुँजिनु- --- अ.क्रि. [कुँजो+इ+नु] --- कुँजो हुनु; रोगादिका कारणले हातगोडा खुम्चिनु।
कुँज्याइ- --- ना. --- कुँज्याउने र कुँजिने क्रिया वा भाव।
कुँज्याइनु- --- क.क्रि. --- कुँजिने पारिनु।
कुँज्याउनु- --- प्रे.क्रि. --- कुँजो पार्नु, हातगोडा नचल्ने पार्नु।
कुँजो- --- वि. [सं. कुब्ज] --- १. शारीरिक विकारले वा रोगले हातगोडा आदि खुम्चिएको। २. हातगोडा आदि नचल्ने अवस्थाको; कुजो।
कुँड्नु- --- स. क्रि. [सं. कुण्ठ?+नु] --- १. चक्कु, खुकुरी आदि हतियारको धार झार्नु वा दोब्याउनु; मुत्त्याउनु; कुँढ्नु। २. कागती, निबुवा, खाँदेको अचार आदिका अमिलाले दाँतमा खिहिऱ्याहट पैदा गर्नु वा दाँतको शक्ति कम पार्नु। ३. चित्त दुखाउनु।
कुँडाइ- --- ना. --- कुँड्ने काम वा प्रक्रिया।
कुँडाइनु- --- क.क्रि. --- कुँड्न लाइनुः कुँड्याइनु।
कुँडाउनु --- प्रे.क्रि. --- कुड्न लाउनु, कुँड्याउनु।
कुँडार- --- ना. [सं. कुण्डागार] --- चारैतिर बेरेर सुरक्षित पारेको ठाउँ।
कुँडिनु- --- अ.क्रि. [कुँड्+इ+नु] --- १. चक्कु, तरबार, हँसिया आदि फलामे हतियारको धार झर्नु वा दोब्रिनु; भुत्तिनु। २. चित्त दुख्नु; मन पाक्नु; भित्र भित्र चिढिनु। ३. अमिलाले दाँतमा खिहिरोपन पैदा हुनु वा दाँतको शक्ति कम हुनु।
कुँडिया- --- ना. [कुँडो+इया] --- १. सानो कुँडे। २. ताउलो।
कुँडी- --- ना. [कुँडो+ई] --- १. सानो कुँडे; कुँडिया। २. तेल पेल्ने कोलको
```
-------------------
